season,league_id,league_name,fixture_id,date_utc,round,home_id,home_name,away_id,away_name,goals_home,goals_away,team_name_x,position_home,points_home,team_name_y,position_away,points_away,points_diff,position_diff
2021,128,Liga Profesional Argentina,674020,2021-02-12T22:15:00+00:00,1st Phase - 1,449,Banfield,436,Racing Club,2,0,Banfield,20,27,Racing Club,15,32,-5,-5
2021,128,Liga Profesional Argentina,674028,2021-02-13T00:30:00+00:00,1st Phase - 1,441,Union Santa Fe,455,Atletico Tucuman,2,2,Union Santa Fe,12,34,Atletico Tucuman,25,22,12,13
2021,128,Liga Profesional Argentina,674022,2021-02-13T00:30:00+00:00,1st Phase - 1,1065,Central Cordoba de Santiago,448,Colon Santa Fe,0,3,Central Cordoba de Santiago,22,26,Colon Santa Fe,7,39,-13,-15
2021,128,Liga Profesional Argentina,674025,2021-02-13T20:10:00+00:00,1st Phase - 1,456,Talleres Cordoba,444,Patronato,1,0,Talleres Cordoba,3,46,Patronato,23,25,21,20
2021,128,Liga Profesional Argentina,674019,2021-02-13T20:10:00+00:00,1st Phase - 1,463,Aldosivi,439,Godoy Cruz,1,2,Aldosivi,13,33,Godoy Cruz,17,31,2,4
2021,128,Liga Profesional Argentina,674023,2021-02-13T22:20:00+00:00,1st Phase - 1,438,Velez Sarsfield,457,Newells Old Boys,1,0,Velez Sarsfield,5,39,Newells Old Boys,19,28,11,14
2021,128,Liga Profesional Argentina,674021,2021-02-14T00:30:00+00:00,1st Phase - 1,460,San Lorenzo,459,Arsenal Sarandi,2,1,San Lorenzo,21,27,Arsenal Sarandi,26,21,6,5
2021,128,Liga Profesional Argentina,674027,2021-02-14T20:10:00+00:00,1st Phase - 1,442,Defensa Y Justicia,445,Huracan,3,2,Defensa Y Justicia,2,47,Huracan,8,38,9,6
2021,128,Liga Profesional Argentina,674024,2021-02-14T22:20:00+00:00,1st Phase - 1,451,Boca Juniors,434,Gimnasia L.P.,2,2,Boca Juniors,4,41,Gimnasia L.P.,11,36,5,7
2021,128,Liga Profesional Argentina,674018,2021-02-15T00:30:00+00:00,1st Phase - 1,450,Estudiantes L.P.,435,River Plate,2,1,Estudiantes L.P.,6,39,River Plate,1,54,-15,-5
2021,128,Liga Profesional Argentina,676619,2021-02-15T22:15:00+00:00,1st Phase - 1,437,Rosario Central,458,Argentinos JRS,2,1,Rosario Central,16,32,Argentinos JRS,14,32,0,-2
2021,128,Liga Profesional Argentina,674026,2021-02-16T00:30:00+00:00,1st Phase - 1,453,Independiente,446,Lanus,0,1,Independiente,9,38,Lanus,10,37,1,1
2021,128,Liga Profesional Argentina,674038,2021-02-19T22:15:00+00:00,1st Phase - 2,434,Gimnasia L.P.,456,Talleres Cordoba,3,0,Gimnasia L.P.,11,36,Talleres Cordoba,3,46,-10,-8
2021,128,Liga Profesional Argentina,674031,2021-02-20T00:30:00+00:00,1st Phase - 2,459,Arsenal Sarandi,449,Banfield,0,2,Arsenal Sarandi,26,21,Banfield,20,27,-6,-6
2021,128,Liga Profesional Argentina,674033,2021-02-20T20:10:00+00:00,1st Phase - 2,439,Godoy Cruz,450,Estudiantes L.P.,0,2,Godoy Cruz,17,31,Estudiantes L.P.,6,39,-8,-11
2021,128,Liga Profesional Argentina,674036,2021-02-20T20:10:00+00:00,1st Phase - 2,446,Lanus,442,Defensa Y Justicia,2,1,Lanus,10,37,Defensa Y Justicia,2,47,-10,-8
2021,128,Liga Profesional Argentina,674032,2021-02-20T22:20:00+00:00,1st Phase - 2,436,Racing Club,463,Aldosivi,2,2,Racing Club,15,32,Aldosivi,13,33,-1,-2
2021,128,Liga Profesional Argentina,676620,2021-02-21T00:30:00+00:00,1st Phase - 2,435,River Plate,437,Rosario Central,3,0,River Plate,1,54,Rosario Central,16,32,22,15
2021,128,Liga Profesional Argentina,674034,2021-02-21T20:10:00+00:00,1st Phase - 2,458,Argentinos JRS,1064,Platense,0,1,Argentinos JRS,14,32,Platense,18,31,1,4
2021,128,Liga Profesional Argentina,674040,2021-02-21T20:10:00+00:00,1st Phase - 2,474,Sarmiento Junin,438,Velez Sarsfield,1,2,Sarmiento Junin,24,24,Velez Sarsfield,5,39,-15,-19
2021,128,Liga Profesional Argentina,674037,2021-02-21T22:20:00+00:00,1st Phase - 2,444,Patronato,453,Independiente,0,1,Patronato,23,25,Independiente,9,38,-13,-14
2021,128,Liga Profesional Argentina,674039,2021-02-22T00:30:00+00:00,1st Phase - 2,457,Newells Old Boys,451,Boca Juniors,0,1,Newells Old Boys,19,28,Boca Juniors,4,41,-13,-15
2021,128,Liga Profesional Argentina,674035,2021-02-22T22:15:00+00:00,1st Phase - 2,445,Huracan,441,Union Santa Fe,1,1,Huracan,8,38,Union Santa Fe,12,34,4,4
2021,128,Liga Profesional Argentina,674041,2021-02-22T22:15:00+00:00,1st Phase - 2,455,Atletico Tucuman,1065,Central Cordoba de Santiago,1,2,Atletico Tucuman,25,22,Central Cordoba de Santiago,22,26,-4,-3
2021,128,Liga Profesional Argentina,674030,2021-02-23T00:30:00+00:00,1st Phase - 2,448,Colon Santa Fe,460,San Lorenzo,2,0,Colon Santa Fe,7,39,San Lorenzo,21,27,12,14
2021,128,Liga Profesional Argentina,674050,2021-02-26T22:15:00+00:00,1st Phase - 3,442,Defensa Y Justicia,444,Patronato,1,0,Defensa Y Justicia,2,47,Patronato,23,25,22,21
2021,128,Liga Profesional Argentina,674044,2021-02-26T22:15:00+00:00,1st Phase - 3,463,Aldosivi,459,Arsenal Sarandi,3,0,Aldosivi,13,33,Arsenal Sarandi,26,21,12,13
2021,128,Liga Profesional Argentina,674053,2021-02-27T00:30:00+00:00,1st Phase - 3,458,Argentinos JRS,438,Velez Sarsfield,0,2,Argentinos JRS,14,32,Velez Sarsfield,5,39,-7,-9
2021,128,Liga Profesional Argentina,674045,2021-02-27T20:10:00+00:00,1st Phase - 3,449,Banfield,448,Colon Santa Fe,0,3,Banfield,20,27,Colon Santa Fe,7,39,-12,-13
2021,128,Liga Profesional Argentina,674048,2021-02-27T20:10:00+00:00,1st Phase - 3,456,Talleres Cordoba,457,Newells Old Boys,2,2,Talleres Cordoba,3,46,Newells Old Boys,19,28,18,16
2021,128,Liga Profesional Argentina,674049,2021-02-27T22:20:00+00:00,1st Phase - 3,453,Independiente,434,Gimnasia L.P.,1,0,Independiente,9,38,Gimnasia L.P.,11,36,2,2
2021,128,Liga Profesional Argentina,674046,2021-02-28T00:30:00+00:00,1st Phase - 3,460,San Lorenzo,1065,Central Cordoba de Santiago,0,4,San Lorenzo,21,27,Central Cordoba de Santiago,22,26,1,1
2021,128,Liga Profesional Argentina,674042,2021-02-28T20:10:00+00:00,1st Phase - 3,1064,Platense,435,River Plate,0,1,Platense,18,31,River Plate,1,54,-23,-17
2021,128,Liga Profesional Argentina,674043,2021-02-28T22:20:00+00:00,1st Phase - 3,450,Estudiantes L.P.,436,Racing Club,0,0,Estudiantes L.P.,6,39,Racing Club,15,32,7,9
2021,128,Liga Profesional Argentina,674047,2021-03-01T00:30:00+00:00,1st Phase - 3,451,Boca Juniors,474,Sarmiento Junin,1,1,Boca Juniors,4,41,Sarmiento Junin,24,24,17,20
2021,128,Liga Profesional Argentina,674051,2021-03-01T22:15:00+00:00,1st Phase - 3,441,Union Santa Fe,446,Lanus,3,2,Union Santa Fe,12,34,Lanus,10,37,-3,-2
2021,128,Liga Profesional Argentina,676621,2021-03-02T00:30:00+00:00,1st Phase - 3,437,Rosario Central,439,Godoy Cruz,2,2,Rosario Central,16,32,Godoy Cruz,17,31,1,1
2021,128,Liga Profesional Argentina,674062,2021-03-05T22:15:00+00:00,1st Phase - 4,457,Newells Old Boys,453,Independiente,1,2,Newells Old Boys,19,28,Independiente,9,38,-10,-10
2021,128,Liga Profesional Argentina,674054,2021-03-06T00:30:00+00:00,1st Phase - 4,1065,Central Cordoba de Santiago,449,Banfield,1,1,Central Cordoba de Santiago,22,26,Banfield,20,27,-1,-2
2021,128,Liga Profesional Argentina,674057,2021-03-06T20:10:00+00:00,1st Phase - 4,439,Godoy Cruz,1064,Platense,3,1,Godoy Cruz,17,31,Platense,18,31,0,1
2021,128,Liga Profesional Argentina,674063,2021-03-06T20:10:00+00:00,1st Phase - 4,474,Sarmiento Junin,456,Talleres Cordoba,1,1,Sarmiento Junin,24,24,Talleres Cordoba,3,46,-22,-21
2021,128,Liga Profesional Argentina,674059,2021-03-06T22:20:00+00:00,1st Phase - 4,446,Lanus,455,Atletico Tucuman,2,1,Lanus,10,37,Atletico Tucuman,25,22,15,15
2021,128,Liga Profesional Argentina,674055,2021-03-06T22:20:00+00:00,1st Phase - 4,448,Colon Santa Fe,463,Aldosivi,2,1,Colon Santa Fe,7,39,Aldosivi,13,33,6,6
2021,128,Liga Profesional Argentina,674065,2021-03-07T00:30:00+00:00,1st Phase - 4,460,San Lorenzo,445,Huracan,1,1,San Lorenzo,21,27,Huracan,8,38,-11,-13
2021,128,Liga Profesional Argentina,674056,2021-03-07T20:10:00+00:00,1st Phase - 4,459,Arsenal Sarandi,450,Estudiantes L.P.,0,5,Arsenal Sarandi,26,21,Estudiantes L.P.,6,39,-18,-20
2021,128,Liga Profesional Argentina,674061,2021-03-07T22:20:00+00:00,1st Phase - 4,434,Gimnasia L.P.,442,Defensa Y Justicia,1,1,Gimnasia L.P.,11,36,Defensa Y Justicia,2,47,-11,-9
2021,128,Liga Profesional Argentina,674060,2021-03-07T22:20:00+00:00,1st Phase - 4,444,Patronato,441,Union Santa Fe,0,1,Patronato,23,25,Union Santa Fe,12,34,-9,-11
2021,128,Liga Profesional Argentina,674064,2021-03-08T00:30:00+00:00,1st Phase - 4,438,Velez Sarsfield,451,Boca Juniors,1,7,Velez Sarsfield,5,39,Boca Juniors,4,41,-2,-1
2021,128,Liga Profesional Argentina,676622,2021-03-08T22:15:00+00:00,1st Phase - 4,436,Racing Club,437,Rosario Central,1,0,Racing Club,15,32,Rosario Central,16,32,0,1
2021,128,Liga Profesional Argentina,674058,2021-03-09T00:30:00+00:00,1st Phase - 4,435,River Plate,458,Argentinos JRS,0,1,River Plate,1,54,Argentinos JRS,14,32,22,13
2021,128,Liga Profesional Argentina,674029,2021-03-10T20:10:00+00:00,1st Phase - 1,1064,Platense,474,Sarmiento Junin,1,1,Platense,18,31,Sarmiento Junin,24,24,7,6
2021,128,Liga Profesional Argentina,674069,2021-03-12T22:15:00+00:00,1st Phase - 5,463,Aldosivi,1065,Central Cordoba de Santiago,1,2,Aldosivi,13,33,Central Cordoba de Santiago,22,26,7,9
2021,128,Liga Profesional Argentina,674074,2021-03-13T00:30:00+00:00,1st Phase - 5,441,Union Santa Fe,434,Gimnasia L.P.,1,1,Union Santa Fe,12,34,Gimnasia L.P.,11,36,-2,-1
2021,128,Liga Profesional Argentina,674076,2021-03-13T00:30:00+00:00,1st Phase - 5,445,Huracan,446,Lanus,0,0,Huracan,8,38,Lanus,10,37,1,2
2021,128,Liga Profesional Argentina,674071,2021-03-13T20:10:00+00:00,1st Phase - 5,456,Talleres Cordoba,438,Velez Sarsfield,0,1,Talleres Cordoba,3,46,Velez Sarsfield,5,39,7,2
2021,128,Liga Profesional Argentina,674067,2021-03-13T20:10:00+00:00,1st Phase - 5,1064,Platense,436,Racing Club,0,2,Platense,18,31,Racing Club,15,32,-1,-3
2021,128,Liga Profesional Argentina,674073,2021-03-13T22:20:00+00:00,1st Phase - 5,442,Defensa Y Justicia,457,Newells Old Boys,4,0,Defensa Y Justicia,2,47,Newells Old Boys,19,28,19,17
2021,128,Liga Profesional Argentina,674066,2021-03-13T22:20:00+00:00,1st Phase - 5,458,Argentinos JRS,439,Godoy Cruz,2,0,Argentinos JRS,14,32,Godoy Cruz,17,31,1,3
2021,128,Liga Profesional Argentina,674068,2021-03-14T00:30:00+00:00,1st Phase - 5,450,Estudiantes L.P.,448,Colon Santa Fe,0,2,Estudiantes L.P.,6,39,Colon Santa Fe,7,39,0,1
2021,128,Liga Profesional Argentina,674077,2021-03-14T21:00:00+00:00,1st Phase - 5,451,Boca Juniors,435,River Plate,1,1,Boca Juniors,4,41,River Plate,1,54,-13,-3
2021,128,Liga Profesional Argentina,674070,2021-03-15T00:30:00+00:00,1st Phase - 5,449,Banfield,460,San Lorenzo,0,0,Banfield,20,27,San Lorenzo,21,27,0,1
2021,128,Liga Profesional Argentina,676623,2021-03-15T22:15:00+00:00,1st Phase - 5,437,Rosario Central,459,Arsenal Sarandi,2,1,Rosario Central,16,32,Arsenal Sarandi,26,21,11,10
2021,128,Liga Profesional Argentina,674075,2021-03-15T22:15:00+00:00,1st Phase - 5,455,Atletico Tucuman,444,Patronato,4,2,Atletico Tucuman,25,22,Patronato,23,25,-3,-2
2021,128,Liga Profesional Argentina,674072,2021-03-16T00:30:00+00:00,1st Phase - 5,453,Independiente,474,Sarmiento Junin,6,0,Independiente,9,38,Sarmiento Junin,24,24,14,15
2021,128,Liga Profesional Argentina,674085,2021-03-19T22:00:00+00:00,1st Phase - 6,457,Newells Old Boys,441,Union Santa Fe,0,0,Newells Old Boys,19,28,Union Santa Fe,12,34,-6,-7
2021,128,Liga Profesional Argentina,674079,2021-03-20T00:15:00+00:00,1st Phase - 6,1065,Central Cordoba de Santiago,450,Estudiantes L.P.,1,1,Central Cordoba de Santiago,22,26,Estudiantes L.P.,6,39,-13,-16
2021,128,Liga Profesional Argentina,674084,2021-03-20T17:00:00+00:00,1st Phase - 6,434,Gimnasia L.P.,455,Atletico Tucuman,2,0,Gimnasia L.P.,11,36,Atletico Tucuman,25,22,14,14
2021,128,Liga Profesional Argentina,674083,2021-03-20T17:00:00+00:00,1st Phase - 6,444,Patronato,445,Huracan,0,1,Patronato,23,25,Huracan,8,38,-13,-15
2021,128,Liga Profesional Argentina,674089,2021-03-20T19:15:00+00:00,1st Phase - 6,449,Banfield,446,Lanus,2,0,Banfield,20,27,Lanus,10,37,-10,-10
2021,128,Liga Profesional Argentina,674087,2021-03-20T21:30:00+00:00,1st Phase - 6,438,Velez Sarsfield,453,Independiente,1,0,Velez Sarsfield,5,39,Independiente,9,38,1,4
2021,128,Liga Profesional Argentina,674082,2021-03-21T00:00:00+00:00,1st Phase - 6,439,Godoy Cruz,435,River Plate,1,6,Godoy Cruz,17,31,River Plate,1,54,-23,-16
2021,128,Liga Profesional Argentina,674086,2021-03-21T17:00:00+00:00,1st Phase - 6,474,Sarmiento Junin,442,Defensa Y Justicia,3,1,Sarmiento Junin,24,24,Defensa Y Justicia,2,47,-23,-22
2021,128,Liga Profesional Argentina,676624,2021-03-21T19:15:00+00:00,1st Phase - 6,448,Colon Santa Fe,437,Rosario Central,0,0,Colon Santa Fe,7,39,Rosario Central,16,32,7,9
2021,128,Liga Profesional Argentina,674078,2021-03-21T21:30:00+00:00,1st Phase - 6,460,San Lorenzo,463,Aldosivi,1,2,San Lorenzo,21,27,Aldosivi,13,33,-6,-8
2021,128,Liga Profesional Argentina,674088,2021-03-22T00:00:00+00:00,1st Phase - 6,451,Boca Juniors,456,Talleres Cordoba,1,2,Boca Juniors,4,41,Talleres Cordoba,3,46,-5,-1
2021,128,Liga Profesional Argentina,674080,2021-03-22T22:00:00+00:00,1st Phase - 6,459,Arsenal Sarandi,1064,Platense,0,0,Arsenal Sarandi,26,21,Platense,18,31,-10,-8
2021,128,Liga Profesional Argentina,674081,2021-03-23T00:15:00+00:00,1st Phase - 6,436,Racing Club,458,Argentinos JRS,1,0,Racing Club,15,32,Argentinos JRS,14,32,0,-1
2021,128,Liga Profesional Argentina,674052,2021-03-24T22:15:00+00:00,1st Phase - 3,455,Atletico Tucuman,445,Huracan,1,1,Atletico Tucuman,25,22,Huracan,8,38,-16,-17
2021,128,Liga Profesional Argentina,674100,2021-03-26T22:00:00+00:00,1st Phase - 7,446,Lanus,444,Patronato,4,2,Lanus,10,37,Patronato,23,25,12,13
2021,128,Liga Profesional Argentina,674097,2021-03-27T00:15:00+00:00,1st Phase - 7,441,Union Santa Fe,474,Sarmiento Junin,0,0,Union Santa Fe,12,34,Sarmiento Junin,24,24,10,12
2021,128,Liga Profesional Argentina,674092,2021-03-27T17:00:00+00:00,1st Phase - 7,1064,Platense,448,Colon Santa Fe,1,3,Platense,18,31,Colon Santa Fe,7,39,-8,-11
2021,128,Liga Profesional Argentina,674094,2021-03-27T19:15:00+00:00,1st Phase - 7,463,Aldosivi,449,Banfield,1,1,Aldosivi,13,33,Banfield,20,27,6,7
2021,128,Liga Profesional Argentina,674091,2021-03-27T21:30:00+00:00,1st Phase - 7,458,Argentinos JRS,459,Arsenal Sarandi,3,2,Argentinos JRS,14,32,Arsenal Sarandi,26,21,11,12
2021,128,Liga Profesional Argentina,676625,2021-03-27T23:00:00+00:00,1st Phase - 7,437,Rosario Central,1065,Central Cordoba de Santiago,2,2,Rosario Central,16,32,Central Cordoba de Santiago,22,26,6,6
2021,128,Liga Profesional Argentina,674101,2021-03-28T17:00:00+00:00,1st Phase - 7,456,Talleres Cordoba,439,Godoy Cruz,1,1,Talleres Cordoba,3,46,Godoy Cruz,17,31,15,14
2021,128,Liga Profesional Argentina,674096,2021-03-28T19:15:00+00:00,1st Phase - 7,442,Defensa Y Justicia,438,Velez Sarsfield,1,1,Defensa Y Justicia,2,47,Velez Sarsfield,5,39,8,3
2021,128,Liga Profesional Argentina,674090,2021-03-28T21:30:00+00:00,1st Phase - 7,435,River Plate,436,Racing Club,0,0,River Plate,1,54,Racing Club,15,32,22,14
2021,128,Liga Profesional Argentina,674095,2021-03-29T00:00:00+00:00,1st Phase - 7,453,Independiente,451,Boca Juniors,1,1,Independiente,9,38,Boca Juniors,4,41,-3,-5
2021,128,Liga Profesional Argentina,674099,2021-03-30T00:15:00+00:00,1st Phase - 7,445,Huracan,434,Gimnasia L.P.,1,1,Huracan,8,38,Gimnasia L.P.,11,36,2,3
2021,128,Liga Profesional Argentina,674098,2021-03-30T00:15:00+00:00,1st Phase - 7,455,Atletico Tucuman,457,Newells Old Boys,2,2,Atletico Tucuman,25,22,Newells Old Boys,19,28,-6,-6
2021,128,Liga Profesional Argentina,674093,2021-03-30T22:00:00+00:00,1st Phase - 7,450,Estudiantes L.P.,460,San Lorenzo,0,2,Estudiantes L.P.,6,39,San Lorenzo,21,27,12,15
2021,128,Liga Profesional Argentina,674113,2021-04-02T20:00:00+00:00,1st Phase - 8,444,Patronato,463,Aldosivi,2,0,Patronato,23,25,Aldosivi,13,33,-8,-10
2021,128,Liga Profesional Argentina,676626,2021-04-02T22:15:00+00:00,1st Phase - 8,460,San Lorenzo,437,Rosario Central,2,0,San Lorenzo,21,27,Rosario Central,16,32,-5,-5
2021,128,Liga Profesional Argentina,674103,2021-04-03T00:15:00+00:00,1st Phase - 8,1065,Central Cordoba de Santiago,1064,Platense,0,1,Central Cordoba de Santiago,22,26,Platense,18,31,-5,-4
2021,128,Liga Profesional Argentina,674112,2021-04-03T17:00:00+00:00,1st Phase - 8,456,Talleres Cordoba,453,Independiente,3,1,Talleres Cordoba,3,46,Independiente,9,38,8,6
2021,128,Liga Profesional Argentina,674107,2021-04-03T19:15:00+00:00,1st Phase - 8,434,Gimnasia L.P.,446,Lanus,2,4,Gimnasia L.P.,11,36,Lanus,10,37,-1,-1
2021,128,Liga Profesional Argentina,674109,2021-04-03T19:15:00+00:00,1st Phase - 8,474,Sarmiento Junin,455,Atletico Tucuman,1,2,Sarmiento Junin,24,24,Atletico Tucuman,25,22,2,1
2021,128,Liga Profesional Argentina,674111,2021-04-03T21:30:00+00:00,1st Phase - 8,451,Boca Juniors,442,Defensa Y Justicia,2,1,Boca Juniors,4,41,Defensa Y Justicia,2,47,-6,-2
2021,128,Liga Profesional Argentina,674105,2021-04-04T00:00:00+00:00,1st Phase - 8,459,Arsenal Sarandi,435,River Plate,0,0,Arsenal Sarandi,26,21,River Plate,1,54,-33,-25
2021,128,Liga Profesional Argentina,674108,2021-04-04T17:00:00+00:00,1st Phase - 8,457,Newells Old Boys,445,Huracan,2,2,Newells Old Boys,19,28,Huracan,8,38,-10,-11
2021,128,Liga Profesional Argentina,674104,2021-04-04T19:15:00+00:00,1st Phase - 8,448,Colon Santa Fe,458,Argentinos JRS,0,0,Colon Santa Fe,7,39,Argentinos JRS,14,32,7,7
2021,128,Liga Profesional Argentina,674110,2021-04-04T21:30:00+00:00,1st Phase - 8,438,Velez Sarsfield,441,Union Santa Fe,4,1,Velez Sarsfield,5,39,Union Santa Fe,12,34,5,7
2021,128,Liga Profesional Argentina,674106,2021-04-05T00:00:00+00:00,1st Phase - 8,436,Racing Club,439,Godoy Cruz,2,4,Racing Club,15,32,Godoy Cruz,17,31,1,2
2021,128,Liga Profesional Argentina,674102,2021-04-06T00:15:00+00:00,1st Phase - 8,449,Banfield,450,Estudiantes L.P.,2,2,Banfield,20,27,Estudiantes L.P.,6,39,-12,-14
2021,128,Liga Profesional Argentina,674117,2021-04-10T00:00:00+00:00,1st Phase - 9,1064,Platense,460,San Lorenzo,2,4,Platense,18,31,San Lorenzo,21,27,4,3
2021,128,Liga Profesional Argentina,674118,2021-04-10T19:15:00+00:00,1st Phase - 9,450,Estudiantes L.P.,463,Aldosivi,1,0,Estudiantes L.P.,6,39,Aldosivi,13,33,6,7
2021,128,Liga Profesional Argentina,674119,2021-04-10T21:30:00+00:00,1st Phase - 9,442,Defensa Y Justicia,456,Talleres Cordoba,2,2,Defensa Y Justicia,2,47,Talleres Cordoba,3,46,1,1
2021,128,Liga Profesional Argentina,674125,2021-04-11T00:00:00+00:00,1st Phase - 9,436,Racing Club,453,Independiente,1,0,Racing Club,15,32,Independiente,9,38,-6,-6
2021,128,Liga Profesional Argentina,674114,2021-04-11T14:00:00+00:00,1st Phase - 9,439,Godoy Cruz,459,Arsenal Sarandi,2,3,Godoy Cruz,17,31,Arsenal Sarandi,26,21,10,9
2021,128,Liga Profesional Argentina,674124,2021-04-11T17:00:00+00:00,1st Phase - 9,444,Patronato,434,Gimnasia L.P.,4,1,Patronato,23,25,Gimnasia L.P.,11,36,-11,-12
2021,128,Liga Profesional Argentina,674116,2021-04-11T17:00:00+00:00,1st Phase - 9,458,Argentinos JRS,1065,Central Cordoba de Santiago,0,0,Argentinos JRS,14,32,Central Cordoba de Santiago,22,26,6,8
2021,128,Liga Profesional Argentina,676627,2021-04-11T19:15:00+00:00,1st Phase - 9,437,Rosario Central,449,Banfield,3,1,Rosario Central,16,32,Banfield,20,27,5,4
2021,128,Liga Profesional Argentina,674120,2021-04-11T21:30:00+00:00,1st Phase - 9,441,Union Santa Fe,451,Boca Juniors,1,0,Union Santa Fe,12,34,Boca Juniors,4,41,-7,-8
2021,128,Liga Profesional Argentina,674115,2021-04-12T00:00:00+00:00,1st Phase - 9,435,River Plate,448,Colon Santa Fe,3,2,River Plate,1,54,Colon Santa Fe,7,39,15,6
2021,128,Liga Profesional Argentina,674121,2021-04-13T00:15:00+00:00,1st Phase - 9,455,Atletico Tucuman,438,Velez Sarsfield,2,0,Atletico Tucuman,25,22,Velez Sarsfield,5,39,-17,-20
2021,128,Liga Profesional Argentina,674122,2021-04-13T22:00:00+00:00,1st Phase - 9,445,Huracan,474,Sarmiento Junin,3,0,Huracan,8,38,Sarmiento Junin,24,24,14,16
2021,128,Liga Profesional Argentina,674123,2021-04-13T22:00:00+00:00,1st Phase - 9,446,Lanus,457,Newells Old Boys,1,3,Lanus,10,37,Newells Old Boys,19,28,9,9
2021,128,Liga Profesional Argentina,674135,2021-04-16T18:00:00+00:00,1st Phase - 10,456,Talleres Cordoba,441,Union Santa Fe,3,0,Talleres Cordoba,3,46,Union Santa Fe,12,34,12,9
2021,128,Liga Profesional Argentina,676628,2021-04-16T20:15:00+00:00,1st Phase - 10,463,Aldosivi,437,Rosario Central,0,1,Aldosivi,13,33,Rosario Central,16,32,1,3
2021,128,Liga Profesional Argentina,674133,2021-04-16T21:00:00+00:00,1st Phase - 10,438,Velez Sarsfield,445,Huracan,2,0,Velez Sarsfield,5,39,Huracan,8,38,1,3
2021,128,Liga Profesional Argentina,674128,2021-04-17T00:30:00+00:00,1st Phase - 10,1065,Central Cordoba de Santiago,435,River Plate,0,5,Central Cordoba de Santiago,22,26,River Plate,1,54,-28,-21
2021,128,Liga Profesional Argentina,674132,2021-04-17T16:30:00+00:00,1st Phase - 10,474,Sarmiento Junin,446,Lanus,1,0,Sarmiento Junin,24,24,Lanus,10,37,-13,-14
2021,128,Liga Profesional Argentina,674127,2021-04-17T18:45:00+00:00,1st Phase - 10,460,San Lorenzo,458,Argentinos JRS,1,1,San Lorenzo,21,27,Argentinos JRS,14,32,-5,-7
2021,128,Liga Profesional Argentina,674134,2021-04-17T21:00:00+00:00,1st Phase - 10,451,Boca Juniors,455,Atletico Tucuman,3,1,Boca Juniors,4,41,Atletico Tucuman,25,22,19,21
2021,128,Liga Profesional Argentina,674131,2021-04-17T23:15:00+00:00,1st Phase - 10,457,Newells Old Boys,444,Patronato,2,0,Newells Old Boys,19,28,Patronato,23,25,3,4
2021,128,Liga Profesional Argentina,674130,2021-04-18T16:30:00+00:00,1st Phase - 10,459,Arsenal Sarandi,436,Racing Club,2,1,Arsenal Sarandi,26,21,Racing Club,15,32,-11,-11
2021,128,Liga Profesional Argentina,674137,2021-04-18T18:45:00+00:00,1st Phase - 10,450,Estudiantes L.P.,434,Gimnasia L.P.,0,0,Estudiantes L.P.,6,39,Gimnasia L.P.,11,36,3,5
2021,128,Liga Profesional Argentina,674136,2021-04-18T21:00:00+00:00,1st Phase - 10,453,Independiente,442,Defensa Y Justicia,1,0,Independiente,9,38,Defensa Y Justicia,2,47,-9,-7
2021,128,Liga Profesional Argentina,674129,2021-04-19T00:00:00+00:00,1st Phase - 10,448,Colon Santa Fe,439,Godoy Cruz,2,2,Colon Santa Fe,7,39,Godoy Cruz,17,31,8,10
2021,128,Liga Profesional Argentina,674126,2021-04-19T21:00:00+00:00,1st Phase - 10,449,Banfield,1064,Platense,0,1,Banfield,20,27,Platense,18,31,-4,-2
2021,128,Liga Profesional Argentina,674139,2021-04-24T00:15:00+00:00,1st Phase - 11,439,Godoy Cruz,1065,Central Cordoba de Santiago,1,0,Godoy Cruz,17,31,Central Cordoba de Santiago,22,26,5,5
2021,128,Liga Profesional Argentina,674147,2021-04-24T16:30:00+00:00,1st Phase - 11,444,Patronato,474,Sarmiento Junin,1,0,Patronato,23,25,Sarmiento Junin,24,24,1,1
2021,128,Liga Profesional Argentina,674141,2021-04-24T18:45:00+00:00,1st Phase - 11,458,Argentinos JRS,449,Banfield,1,1,Argentinos JRS,14,32,Banfield,20,27,5,6
2021,128,Liga Profesional Argentina,674145,2021-04-24T21:00:00+00:00,1st Phase - 11,445,Huracan,451,Boca Juniors,0,2,Huracan,8,38,Boca Juniors,4,41,-3,-4
2021,128,Liga Profesional Argentina,674143,2021-04-25T00:00:00+00:00,1st Phase - 11,441,Union Santa Fe,453,Independiente,0,0,Union Santa Fe,12,34,Independiente,9,38,-4,-3
2021,128,Liga Profesional Argentina,674146,2021-04-25T14:00:00+00:00,1st Phase - 11,446,Lanus,438,Velez Sarsfield,1,2,Lanus,10,37,Velez Sarsfield,5,39,-2,-5
2021,128,Liga Profesional Argentina,674149,2021-04-25T16:30:00+00:00,1st Phase - 11,442,Defensa Y Justicia,459,Arsenal Sarandi,0,1,Defensa Y Justicia,2,47,Arsenal Sarandi,26,21,26,24
2021,128,Liga Profesional Argentina,674138,2021-04-25T18:45:00+00:00,1st Phase - 11,436,Racing Club,448,Colon Santa Fe,2,1,Racing Club,15,32,Colon Santa Fe,7,39,-7,-8
2021,128,Liga Profesional Argentina,674140,2021-04-25T21:00:00+00:00,1st Phase - 11,435,River Plate,460,San Lorenzo,1,2,River Plate,1,54,San Lorenzo,21,27,27,20
2021,128,Liga Profesional Argentina,676629,2021-04-26T00:00:00+00:00,1st Phase - 11,437,Rosario Central,450,Estudiantes L.P.,0,1,Rosario Central,16,32,Estudiantes L.P.,6,39,-7,-10
2021,128,Liga Profesional Argentina,674144,2021-04-26T00:00:00+00:00,1st Phase - 11,455,Atletico Tucuman,456,Talleres Cordoba,2,3,Atletico Tucuman,25,22,Talleres Cordoba,3,46,-24,-22
2021,128,Liga Profesional Argentina,674142,2021-04-26T18:45:00+00:00,1st Phase - 11,1064,Platense,463,Aldosivi,0,2,Platense,18,31,Aldosivi,13,33,-2,-5
2021,128,Liga Profesional Argentina,674148,2021-04-26T21:00:00+00:00,1st Phase - 11,434,Gimnasia L.P.,457,Newells Old Boys,2,1,Gimnasia L.P.,11,36,Newells Old Boys,19,28,8,8
2021,128,Liga Profesional Argentina,674157,2021-04-30T21:00:00+00:00,1st Phase - 12,438,Velez Sarsfield,444,Patronato,1,0,Velez Sarsfield,5,39,Patronato,23,25,14,18
2021,128,Liga Profesional Argentina,674155,2021-05-01T00:00:00+00:00,1st Phase - 12,448,Colon Santa Fe,459,Arsenal Sarandi,2,0,Colon Santa Fe,7,39,Arsenal Sarandi,26,21,18,19
2021,128,Liga Profesional Argentina,674158,2021-05-02T13:00:00+00:00,1st Phase - 12,451,Boca Juniors,446,Lanus,1,0,Boca Juniors,4,41,Lanus,10,37,4,6
2021,128,Liga Profesional Argentina,674161,2021-05-02T15:10:00+00:00,1st Phase - 12,442,Defensa Y Justicia,441,Union Santa Fe,0,1,Defensa Y Justicia,2,47,Union Santa Fe,12,34,13,10
2021,128,Liga Profesional Argentina,674160,2021-05-02T15:10:00+00:00,1st Phase - 12,453,Independiente,455,Atletico Tucuman,0,1,Independiente,9,38,Atletico Tucuman,25,22,16,16
2021,128,Liga Profesional Argentina,674159,2021-05-02T17:20:00+00:00,1st Phase - 12,456,Talleres Cordoba,445,Huracan,1,1,Talleres Cordoba,3,46,Huracan,8,38,8,5
2021,128,Liga Profesional Argentina,674153,2021-05-02T17:20:00+00:00,1st Phase - 12,460,San Lorenzo,439,Godoy Cruz,1,0,San Lorenzo,21,27,Godoy Cruz,17,31,-4,-4
2021,128,Liga Profesional Argentina,674152,2021-05-02T19:30:00+00:00,1st Phase - 12,449,Banfield,435,River Plate,1,0,Banfield,20,27,River Plate,1,54,-27,-19
2021,128,Liga Profesional Argentina,674151,2021-05-02T21:40:00+00:00,1st Phase - 12,463,Aldosivi,458,Argentinos JRS,1,3,Aldosivi,13,33,Argentinos JRS,14,32,1,1
2021,128,Liga Profesional Argentina,674154,2021-05-02T21:40:00+00:00,1st Phase - 12,1065,Central Cordoba de Santiago,436,Racing Club,1,0,Central Cordoba de Santiago,22,26,Racing Club,15,32,-6,-7
2021,128,Liga Profesional Argentina,676630,2021-05-03T00:00:00+00:00,1st Phase - 12,437,Rosario Central,457,Newells Old Boys,3,0,Rosario Central,16,32,Newells Old Boys,19,28,4,3
2021,128,Liga Profesional Argentina,674156,2021-05-03T18:45:00+00:00,1st Phase - 12,474,Sarmiento Junin,434,Gimnasia L.P.,0,0,Sarmiento Junin,24,24,Gimnasia L.P.,11,36,-12,-13
2021,128,Liga Profesional Argentina,674150,2021-05-03T21:00:00+00:00,1st Phase - 12,450,Estudiantes L.P.,1064,Platense,2,0,Estudiantes L.P.,6,39,Platense,18,31,8,12
2021,128,Liga Profesional Argentina,674164,2021-05-08T16:00:00+00:00,1st Phase - 13,439,Godoy Cruz,449,Banfield,0,1,Godoy Cruz,17,31,Banfield,20,27,4,3
2021,128,Liga Profesional Argentina,674171,2021-05-08T18:30:00+00:00,1st Phase - 13,434,Gimnasia L.P.,438,Velez Sarsfield,0,5,Gimnasia L.P.,11,36,Velez Sarsfield,5,39,-3,-6
2021,128,Liga Profesional Argentina,674167,2021-05-08T18:30:00+00:00,1st Phase - 13,455,Atletico Tucuman,442,Defensa Y Justicia,5,0,Atletico Tucuman,25,22,Defensa Y Justicia,2,47,-25,-23
2021,128,Liga Profesional Argentina,674170,2021-05-08T21:00:00+00:00,1st Phase - 13,444,Patronato,451,Boca Juniors,1,0,Patronato,23,25,Boca Juniors,4,41,-16,-19
2021,128,Liga Profesional Argentina,674162,2021-05-09T13:00:00+00:00,1st Phase - 13,459,Arsenal Sarandi,1065,Central Cordoba de Santiago,1,1,Arsenal Sarandi,26,21,Central Cordoba de Santiago,22,26,-5,-4
2021,128,Liga Profesional Argentina,674166,2021-05-09T15:10:00+00:00,1st Phase - 13,458,Argentinos JRS,450,Estudiantes L.P.,2,0,Argentinos JRS,14,32,Estudiantes L.P.,6,39,-7,-8
2021,128,Liga Profesional Argentina,674165,2021-05-09T17:30:00+00:00,1st Phase - 13,435,River Plate,463,Aldosivi,4,1,River Plate,1,54,Aldosivi,13,33,21,12
2021,128,Liga Profesional Argentina,674163,2021-05-09T17:30:00+00:00,1st Phase - 13,436,Racing Club,460,San Lorenzo,2,0,Racing Club,15,32,San Lorenzo,21,27,5,6
2021,128,Liga Profesional Argentina,676631,2021-05-09T17:30:00+00:00,1st Phase - 13,1064,Platense,437,Rosario Central,4,1,Platense,18,31,Rosario Central,16,32,-1,-2
2021,128,Liga Profesional Argentina,674168,2021-05-09T21:00:00+00:00,1st Phase - 13,445,Huracan,453,Independiente,1,3,Huracan,8,38,Independiente,9,38,0,1
2021,128,Liga Profesional Argentina,674169,2021-05-09T21:00:00+00:00,1st Phase - 13,446,Lanus,456,Talleres Cordoba,1,0,Lanus,10,37,Talleres Cordoba,3,46,-9,-7
2021,128,Liga Profesional Argentina,674173,2021-05-09T21:00:00+00:00,1st Phase - 13,448,Colon Santa Fe,441,Union Santa Fe,1,1,Colon Santa Fe,7,39,Union Santa Fe,12,34,5,5
2021,128,Liga Profesional Argentina,674172,2021-05-10T00:00:00+00:00,1st Phase - 13,457,Newells Old Boys,474,Sarmiento Junin,1,1,Newells Old Boys,19,28,Sarmiento Junin,24,24,4,5
2021,128,Liga Profesional Argentina,702751,2021-05-15T20:30:00+00:00,1st Phase - Quarter-finals,450,Estudiantes L.P.,453,Independiente,0,0,Estudiantes L.P.,6,39,Independiente,9,38,1,3
2021,128,Liga Profesional Argentina,702750,2021-05-16T00:00:00+00:00,1st Phase - Quarter-finals,448,Colon Santa Fe,456,Talleres Cordoba,1,1,Colon Santa Fe,7,39,Talleres Cordoba,3,46,-7,-4
2021,128,Liga Profesional Argentina,702752,2021-05-16T15:00:00+00:00,1st Phase - Quarter-finals,438,Velez Sarsfield,436,Racing Club,0,0,Velez Sarsfield,5,39,Racing Club,15,32,7,10
2021,128,Liga Profesional Argentina,702753,2021-05-16T20:30:00+00:00,1st Phase - Quarter-finals,451,Boca Juniors,435,River Plate,1,1,Boca Juniors,4,41,River Plate,1,54,-13,-3
2021,128,Liga Profesional Argentina,704737,2021-05-31T18:00:00+00:00,1st Phase - Semi-finals,436,Racing Club,451,Boca Juniors,0,0,Racing Club,15,32,Boca Juniors,4,41,-9,-11
2021,128,Liga Profesional Argentina,704736,2021-05-31T22:00:00+00:00,1st Phase - Semi-finals,453,Independiente,448,Colon Santa Fe,0,2,Independiente,9,38,Colon Santa Fe,7,39,-1,-2
2021,128,Liga Profesional Argentina,706424,2021-06-04T22:00:00+00:00,1st Phase - Final,448,Colon Santa Fe,436,Racing Club,3,0,Colon Santa Fe,7,39,Racing Club,15,32,7,8
2021,128,Liga Profesional Argentina,720180,2021-07-16T22:00:00+00:00,2nd Phase - 1,441,Union Santa Fe,451,Boca Juniors,1,1,Union Santa Fe,12,34,Boca Juniors,4,41,-7,-8
2021,128,Liga Profesional Argentina,720185,2021-07-17T00:15:00+00:00,2nd Phase - 1,474,Sarmiento Junin,450,Estudiantes L.P.,0,3,Sarmiento Junin,24,24,Estudiantes L.P.,6,39,-15,-18
2021,128,Liga Profesional Argentina,720186,2021-07-17T16:30:00+00:00,2nd Phase - 1,463,Aldosivi,444,Patronato,0,2,Aldosivi,13,33,Patronato,23,25,8,10
2021,128,Liga Profesional Argentina,720191,2021-07-17T18:45:00+00:00,2nd Phase - 1,446,Lanus,455,Atletico Tucuman,4,2,Lanus,10,37,Atletico Tucuman,25,22,15,15
2021,128,Liga Profesional Argentina,720183,2021-07-17T18:45:00+00:00,2nd Phase - 1,457,Newells Old Boys,456,Talleres Cordoba,3,2,Newells Old Boys,19,28,Talleres Cordoba,3,46,-18,-16
2021,128,Liga Profesional Argentina,720187,2021-07-17T21:00:00+00:00,2nd Phase - 1,434,Gimnasia L.P.,1064,Platense,2,2,Gimnasia L.P.,11,36,Platense,18,31,5,7
2021,128,Liga Profesional Argentina,720188,2021-07-17T23:15:00+00:00,2nd Phase - 1,438,Velez Sarsfield,436,Racing Club,0,0,Velez Sarsfield,5,39,Racing Club,15,32,7,10
2021,128,Liga Profesional Argentina,720190,2021-07-18T16:30:00+00:00,2nd Phase - 1,445,Huracan,442,Defensa Y Justicia,2,1,Huracan,8,38,Defensa Y Justicia,2,47,-9,-6
2021,128,Liga Profesional Argentina,720182,2021-07-18T18:45:00+00:00,2nd Phase - 1,459,Arsenal Sarandi,460,San Lorenzo,1,1,Arsenal Sarandi,26,21,San Lorenzo,21,27,-6,-5
2021,128,Liga Profesional Argentina,720192,2021-07-18T21:00:00+00:00,2nd Phase - 1,435,River Plate,448,Colon Santa Fe,1,2,River Plate,1,54,Colon Santa Fe,7,39,15,6
2021,128,Liga Profesional Argentina,720184,2021-07-18T23:15:00+00:00,2nd Phase - 1,453,Independiente,458,Argentinos JRS,0,0,Independiente,9,38,Argentinos JRS,14,32,6,5
2021,128,Liga Profesional Argentina,720181,2021-07-19T21:00:00+00:00,2nd Phase - 1,1065,Central Cordoba de Santiago,449,Banfield,1,1,Central Cordoba de Santiago,22,26,Banfield,20,27,-1,-2
2021,128,Liga Profesional Argentina,720189,2021-07-19T23:15:00+00:00,2nd Phase - 1,439,Godoy Cruz,437,Rosario Central,2,1,Godoy Cruz,17,31,Rosario Central,16,32,-1,-1
2021,128,Liga Profesional Argentina,720195,2021-07-23T22:00:00+00:00,2nd Phase - 2,455,Atletico Tucuman,445,Huracan,1,0,Atletico Tucuman,25,22,Huracan,8,38,-16,-17
2021,128,Liga Profesional Argentina,720199,2021-07-24T00:15:00+00:00,2nd Phase - 2,1064,Platense,463,Aldosivi,0,1,Platense,18,31,Aldosivi,13,33,-2,-5
2021,128,Liga Profesional Argentina,720194,2021-07-24T16:30:00+00:00,2nd Phase - 2,448,Colon Santa Fe,446,Lanus,1,4,Colon Santa Fe,7,39,Lanus,10,37,2,3
2021,128,Liga Profesional Argentina,720204,2021-07-24T18:45:00+00:00,2nd Phase - 2,460,San Lorenzo,1065,Central Cordoba de Santiago,1,0,San Lorenzo,21,27,Central Cordoba de Santiago,22,26,1,1
2021,128,Liga Profesional Argentina,720198,2021-07-24T21:00:00+00:00,2nd Phase - 2,436,Racing Club,434,Gimnasia L.P.,0,0,Racing Club,15,32,Gimnasia L.P.,11,36,-4,-4
2021,128,Liga Profesional Argentina,720205,2021-07-24T23:15:00+00:00,2nd Phase - 2,449,Banfield,451,Boca Juniors,0,0,Banfield,20,27,Boca Juniors,4,41,-14,-16
2021,128,Liga Profesional Argentina,720196,2021-07-25T16:30:00+00:00,2nd Phase - 2,442,Defensa Y Justicia,439,Godoy Cruz,1,2,Defensa Y Justicia,2,47,Godoy Cruz,17,31,16,15
2021,128,Liga Profesional Argentina,720200,2021-07-25T16:30:00+00:00,2nd Phase - 2,444,Patronato,474,Sarmiento Junin,2,0,Patronato,23,25,Sarmiento Junin,24,24,1,1
2021,128,Liga Profesional Argentina,720197,2021-07-25T18:45:00+00:00,2nd Phase - 2,437,Rosario Central,438,Velez Sarsfield,1,0,Rosario Central,16,32,Velez Sarsfield,5,39,-7,-11
2021,128,Liga Profesional Argentina,720193,2021-07-25T21:00:00+00:00,2nd Phase - 2,435,River Plate,441,Union Santa Fe,4,0,River Plate,1,54,Union Santa Fe,12,34,20,11
2021,128,Liga Profesional Argentina,720201,2021-07-25T23:15:00+00:00,2nd Phase - 2,450,Estudiantes L.P.,453,Independiente,0,1,Estudiantes L.P.,6,39,Independiente,9,38,1,3
2021,128,Liga Profesional Argentina,720203,2021-07-26T21:00:00+00:00,2nd Phase - 2,456,Talleres Cordoba,459,Arsenal Sarandi,2,0,Talleres Cordoba,3,46,Arsenal Sarandi,26,21,25,23
2021,128,Liga Profesional Argentina,720202,2021-07-26T23:15:00+00:00,2nd Phase - 2,458,Argentinos JRS,457,Newells Old Boys,1,0,Argentinos JRS,14,32,Newells Old Boys,19,28,4,5
2021,128,Liga Profesional Argentina,720217,2021-07-27T19:30:00+00:00,2nd Phase - 3,445,Huracan,448,Colon Santa Fe,1,1,Huracan,8,38,Colon Santa Fe,7,39,-1,-1
2021,128,Liga Profesional Argentina,720213,2021-07-27T21:45:00+00:00,2nd Phase - 3,463,Aldosivi,436,Racing Club,0,2,Aldosivi,13,33,Racing Club,15,32,1,2
2021,128,Liga Profesional Argentina,720207,2021-07-28T00:00:00+00:00,2nd Phase - 3,451,Boca Juniors,460,San Lorenzo,0,2,Boca Juniors,4,41,San Lorenzo,21,27,14,17
2021,128,Liga Profesional Argentina,720216,2021-07-28T17:15:00+00:00,2nd Phase - 3,439,Godoy Cruz,455,Atletico Tucuman,1,2,Godoy Cruz,17,31,Atletico Tucuman,25,22,9,8
2021,128,Liga Profesional Argentina,720206,2021-07-28T17:15:00+00:00,2nd Phase - 3,441,Union Santa Fe,449,Banfield,0,1,Union Santa Fe,12,34,Banfield,20,27,7,8
2021,128,Liga Profesional Argentina,720215,2021-07-28T19:30:00+00:00,2nd Phase - 3,438,Velez Sarsfield,442,Defensa Y Justicia,0,0,Velez Sarsfield,5,39,Defensa Y Justicia,2,47,-8,-3
2021,128,Liga Profesional Argentina,720212,2021-07-28T19:30:00+00:00,2nd Phase - 3,474,Sarmiento Junin,1064,Platense,1,0,Sarmiento Junin,24,24,Platense,18,31,-7,-6
2021,128,Liga Profesional Argentina,720211,2021-07-28T21:45:00+00:00,2nd Phase - 3,453,Independiente,444,Patronato,2,0,Independiente,9,38,Patronato,23,25,13,14
2021,128,Liga Profesional Argentina,720218,2021-07-29T00:00:00+00:00,2nd Phase - 3,446,Lanus,435,River Plate,0,3,Lanus,10,37,River Plate,1,54,-17,-9
2021,128,Liga Profesional Argentina,720208,2021-07-29T17:15:00+00:00,2nd Phase - 3,1065,Central Cordoba de Santiago,456,Talleres Cordoba,2,1,Central Cordoba de Santiago,22,26,Talleres Cordoba,3,46,-20,-19
2021,128,Liga Profesional Argentina,720209,2021-07-29T19:30:00+00:00,2nd Phase - 3,459,Arsenal Sarandi,458,Argentinos JRS,1,0,Arsenal Sarandi,26,21,Argentinos JRS,14,32,-11,-12
2021,128,Liga Profesional Argentina,720214,2021-07-29T21:45:00+00:00,2nd Phase - 3,434,Gimnasia L.P.,437,Rosario Central,1,0,Gimnasia L.P.,11,36,Rosario Central,16,32,4,5
2021,128,Liga Profesional Argentina,720210,2021-07-30T00:00:00+00:00,2nd Phase - 3,457,Newells Old Boys,450,Estudiantes L.P.,4,2,Newells Old Boys,19,28,Estudiantes L.P.,6,39,-11,-13
2021,128,Liga Profesional Argentina,720221,2021-07-31T16:30:00+00:00,2nd Phase - 4,448,Colon Santa Fe,439,Godoy Cruz,1,0,Colon Santa Fe,7,39,Godoy Cruz,17,31,8,10
2021,128,Liga Profesional Argentina,720219,2021-07-31T18:45:00+00:00,2nd Phase - 4,446,Lanus,441,Union Santa Fe,1,1,Lanus,10,37,Union Santa Fe,12,34,3,2
2021,128,Liga Profesional Argentina,720225,2021-07-31T21:00:00+00:00,2nd Phase - 4,436,Racing Club,474,Sarmiento Junin,1,0,Racing Club,15,32,Sarmiento Junin,24,24,8,9
2021,128,Liga Profesional Argentina,720226,2021-07-31T23:15:00+00:00,2nd Phase - 4,1064,Platense,453,Independiente,1,1,Platense,18,31,Independiente,9,38,-7,-9
2021,128,Liga Profesional Argentina,720223,2021-08-01T16:30:00+00:00,2nd Phase - 4,442,Defensa Y Justicia,434,Gimnasia L.P.,3,2,Defensa Y Justicia,2,47,Gimnasia L.P.,11,36,11,9
2021,128,Liga Profesional Argentina,720230,2021-08-01T18:45:00+00:00,2nd Phase - 4,456,Talleres Cordoba,451,Boca Juniors,0,0,Talleres Cordoba,3,46,Boca Juniors,4,41,5,1
2021,128,Liga Profesional Argentina,720220,2021-08-01T21:00:00+00:00,2nd Phase - 4,435,River Plate,445,Huracan,1,1,River Plate,1,54,Huracan,8,38,16,7
2021,128,Liga Profesional Argentina,720231,2021-08-01T23:15:00+00:00,2nd Phase - 4,460,San Lorenzo,449,Banfield,1,1,San Lorenzo,21,27,Banfield,20,27,0,-1
2021,128,Liga Profesional Argentina,720227,2021-08-02T19:45:00+00:00,2nd Phase - 4,444,Patronato,457,Newells Old Boys,0,0,Patronato,23,25,Newells Old Boys,19,28,-3,-4
2021,128,Liga Profesional Argentina,720229,2021-08-02T19:45:00+00:00,2nd Phase - 4,458,Argentinos JRS,1065,Central Cordoba de Santiago,1,1,Argentinos JRS,14,32,Central Cordoba de Santiago,22,26,6,8
2021,128,Liga Profesional Argentina,720224,2021-08-02T22:00:00+00:00,2nd Phase - 4,437,Rosario Central,463,Aldosivi,1,2,Rosario Central,16,32,Aldosivi,13,33,-1,-3
2021,128,Liga Profesional Argentina,720228,2021-08-02T22:00:00+00:00,2nd Phase - 4,450,Estudiantes L.P.,459,Arsenal Sarandi,4,0,Estudiantes L.P.,6,39,Arsenal Sarandi,26,21,18,20
2021,128,Liga Profesional Argentina,720222,2021-08-03T00:15:00+00:00,2nd Phase - 4,455,Atletico Tucuman,438,Velez Sarsfield,0,0,Atletico Tucuman,25,22,Velez Sarsfield,5,39,-17,-20
2021,128,Liga Profesional Argentina,720239,2021-08-06T22:00:00+00:00,2nd Phase - 5,474,Sarmiento Junin,437,Rosario Central,1,0,Sarmiento Junin,24,24,Rosario Central,16,32,-8,-8
2021,128,Liga Profesional Argentina,720237,2021-08-07T00:15:00+00:00,2nd Phase - 5,457,Newells Old Boys,1064,Platense,1,0,Newells Old Boys,19,28,Platense,18,31,-3,-1
2021,128,Liga Profesional Argentina,720233,2021-08-07T16:30:00+00:00,2nd Phase - 5,449,Banfield,456,Talleres Cordoba,0,1,Banfield,20,27,Talleres Cordoba,3,46,-19,-17
2021,128,Liga Profesional Argentina,720232,2021-08-07T18:45:00+00:00,2nd Phase - 5,441,Union Santa Fe,460,San Lorenzo,4,0,Union Santa Fe,12,34,San Lorenzo,21,27,7,9
2021,128,Liga Profesional Argentina,720244,2021-08-07T21:00:00+00:00,2nd Phase - 5,445,Huracan,446,Lanus,0,1,Huracan,8,38,Lanus,10,37,1,2
2021,128,Liga Profesional Argentina,720243,2021-08-07T23:15:00+00:00,2nd Phase - 5,439,Godoy Cruz,435,River Plate,2,1,Godoy Cruz,17,31,River Plate,1,54,-23,-16
2021,128,Liga Profesional Argentina,720241,2021-08-08T16:30:00+00:00,2nd Phase - 5,434,Gimnasia L.P.,455,Atletico Tucuman,1,0,Gimnasia L.P.,11,36,Atletico Tucuman,25,22,14,14
2021,128,Liga Profesional Argentina,720242,2021-08-08T18:45:00+00:00,2nd Phase - 5,438,Velez Sarsfield,448,Colon Santa Fe,0,1,Velez Sarsfield,5,39,Colon Santa Fe,7,39,0,2
2021,128,Liga Profesional Argentina,720234,2021-08-08T21:00:00+00:00,2nd Phase - 5,451,Boca Juniors,458,Argentinos JRS,1,1,Boca Juniors,4,41,Argentinos JRS,14,32,9,10
2021,128,Liga Profesional Argentina,720238,2021-08-08T23:15:00+00:00,2nd Phase - 5,453,Independiente,436,Racing Club,1,0,Independiente,9,38,Racing Club,15,32,6,6
2021,128,Liga Profesional Argentina,720236,2021-08-09T21:00:00+00:00,2nd Phase - 5,459,Arsenal Sarandi,444,Patronato,2,2,Arsenal Sarandi,26,21,Patronato,23,25,-4,-3
2021,128,Liga Profesional Argentina,720240,2021-08-09T21:00:00+00:00,2nd Phase - 5,463,Aldosivi,442,Defensa Y Justicia,1,0,Aldosivi,13,33,Defensa Y Justicia,2,47,-14,-11
2021,128,Liga Profesional Argentina,720235,2021-08-09T23:15:00+00:00,2nd Phase - 5,1065,Central Cordoba de Santiago,450,Estudiantes L.P.,1,2,Central Cordoba de Santiago,22,26,Estudiantes L.P.,6,39,-13,-16
2021,128,Liga Profesional Argentina,720248,2021-08-13T22:00:00+00:00,2nd Phase - 6,448,Colon Santa Fe,434,Gimnasia L.P.,1,0,Colon Santa Fe,7,39,Gimnasia L.P.,11,36,3,4
2021,128,Liga Profesional Argentina,720245,2021-08-14T00:15:00+00:00,2nd Phase - 6,445,Huracan,441,Union Santa Fe,0,0,Huracan,8,38,Union Santa Fe,12,34,4,4
2021,128,Liga Profesional Argentina,720249,2021-08-14T16:30:00+00:00,2nd Phase - 6,455,Atletico Tucuman,463,Aldosivi,2,2,Atletico Tucuman,25,22,Aldosivi,13,33,-11,-12
2021,128,Liga Profesional Argentina,720256,2021-08-14T18:45:00+00:00,2nd Phase - 6,458,Argentinos JRS,449,Banfield,2,0,Argentinos JRS,14,32,Banfield,20,27,5,6
2021,128,Liga Profesional Argentina,720247,2021-08-14T21:00:00+00:00,2nd Phase - 6,435,River Plate,438,Velez Sarsfield,2,0,River Plate,1,54,Velez Sarsfield,5,39,15,4
2021,128,Liga Profesional Argentina,720251,2021-08-14T23:15:00+00:00,2nd Phase - 6,437,Rosario Central,453,Independiente,1,2,Rosario Central,16,32,Independiente,9,38,-6,-7
2021,128,Liga Profesional Argentina,720254,2021-08-15T16:30:00+00:00,2nd Phase - 6,444,Patronato,1065,Central Cordoba de Santiago,1,0,Patronato,23,25,Central Cordoba de Santiago,22,26,-1,-1
2021,128,Liga Profesional Argentina,720253,2021-08-15T18:45:00+00:00,2nd Phase - 6,1064,Platense,459,Arsenal Sarandi,2,1,Platense,18,31,Arsenal Sarandi,26,21,10,8
2021,128,Liga Profesional Argentina,720255,2021-08-15T21:00:00+00:00,2nd Phase - 6,450,Estudiantes L.P.,451,Boca Juniors,1,0,Estudiantes L.P.,6,39,Boca Juniors,4,41,-2,-2
2021,128,Liga Profesional Argentina,720252,2021-08-15T23:15:00+00:00,2nd Phase - 6,436,Racing Club,457,Newells Old Boys,2,0,Racing Club,15,32,Newells Old Boys,19,28,4,4
2021,128,Liga Profesional Argentina,720257,2021-08-16T21:00:00+00:00,2nd Phase - 6,456,Talleres Cordoba,460,San Lorenzo,2,0,Talleres Cordoba,3,46,San Lorenzo,21,27,19,18
2021,128,Liga Profesional Argentina,720250,2021-08-16T23:15:00+00:00,2nd Phase - 6,442,Defensa Y Justicia,474,Sarmiento Junin,4,2,Defensa Y Justicia,2,47,Sarmiento Junin,24,24,23,22
2021,128,Liga Profesional Argentina,720246,2021-08-16T23:15:00+00:00,2nd Phase - 6,446,Lanus,439,Godoy Cruz,3,1,Lanus,10,37,Godoy Cruz,17,31,6,7
2021,128,Liga Profesional Argentina,720267,2021-08-20T19:45:00+00:00,2nd Phase - 7,463,Aldosivi,448,Colon Santa Fe,3,0,Aldosivi,13,33,Colon Santa Fe,7,39,-6,-6
2021,128,Liga Profesional Argentina,720260,2021-08-20T22:00:00+00:00,2nd Phase - 7,449,Banfield,450,Estudiantes L.P.,1,1,Banfield,20,27,Estudiantes L.P.,6,39,-12,-14
2021,128,Liga Profesional Argentina,720266,2021-08-20T22:00:00+00:00,2nd Phase - 7,474,Sarmiento Junin,455,Atletico Tucuman,3,0,Sarmiento Junin,24,24,Atletico Tucuman,25,22,2,1
2021,128,Liga Profesional Argentina,720265,2021-08-21T00:15:00+00:00,2nd Phase - 7,453,Independiente,442,Defensa Y Justicia,0,0,Independiente,9,38,Defensa Y Justicia,2,47,-9,-7
2021,128,Liga Profesional Argentina,720270,2021-08-21T16:30:00+00:00,2nd Phase - 7,439,Godoy Cruz,445,Huracan,1,1,Godoy Cruz,17,31,Huracan,8,38,-7,-9
2021,128,Liga Profesional Argentina,720262,2021-08-21T16:30:00+00:00,2nd Phase - 7,1065,Central Cordoba de Santiago,1064,Platense,2,2,Central Cordoba de Santiago,22,26,Platense,18,31,-5,-4
2021,128,Liga Profesional Argentina,720269,2021-08-21T18:45:00+00:00,2nd Phase - 7,438,Velez Sarsfield,446,Lanus,5,1,Velez Sarsfield,5,39,Lanus,10,37,2,5
2021,128,Liga Profesional Argentina,720263,2021-08-21T21:00:00+00:00,2nd Phase - 7,459,Arsenal Sarandi,436,Racing Club,0,3,Arsenal Sarandi,26,21,Racing Club,15,32,-11,-11
2021,128,Liga Profesional Argentina,720261,2021-08-21T23:15:00+00:00,2nd Phase - 7,451,Boca Juniors,444,Patronato,1,0,Boca Juniors,4,41,Patronato,23,25,16,19
2021,128,Liga Profesional Argentina,720258,2021-08-22T16:30:00+00:00,2nd Phase - 7,441,Union Santa Fe,456,Talleres Cordoba,1,2,Union Santa Fe,12,34,Talleres Cordoba,3,46,-12,-9
2021,128,Liga Profesional Argentina,720264,2021-08-22T18:45:00+00:00,2nd Phase - 7,457,Newells Old Boys,437,Rosario Central,1,1,Newells Old Boys,19,28,Rosario Central,16,32,-4,-3
2021,128,Liga Profesional Argentina,720259,2021-08-22T21:00:00+00:00,2nd Phase - 7,460,San Lorenzo,458,Argentinos JRS,0,1,San Lorenzo,21,27,Argentinos JRS,14,32,-5,-7
2021,128,Liga Profesional Argentina,720268,2021-08-22T23:15:00+00:00,2nd Phase - 7,434,Gimnasia L.P.,435,River Plate,1,1,Gimnasia L.P.,11,36,River Plate,1,54,-18,-10
2021,128,Liga Profesional Argentina,720281,2021-08-24T17:15:00+00:00,2nd Phase - 8,444,Patronato,449,Banfield,1,1,Patronato,23,25,Banfield,20,27,-2,-3
2021,128,Liga Profesional Argentina,720275,2021-08-24T19:30:00+00:00,2nd Phase - 8,448,Colon Santa Fe,474,Sarmiento Junin,1,1,Colon Santa Fe,7,39,Sarmiento Junin,24,24,15,17
2021,128,Liga Profesional Argentina,720276,2021-08-24T21:45:00+00:00,2nd Phase - 8,455,Atletico Tucuman,453,Independiente,2,0,Atletico Tucuman,25,22,Independiente,9,38,-16,-16
2021,128,Liga Profesional Argentina,720279,2021-08-25T00:00:00+00:00,2nd Phase - 8,436,Racing Club,1065,Central Cordoba de Santiago,0,0,Racing Club,15,32,Central Cordoba de Santiago,22,26,6,7
2021,128,Liga Profesional Argentina,720278,2021-08-25T17:15:00+00:00,2nd Phase - 8,437,Rosario Central,459,Arsenal Sarandi,4,0,Rosario Central,16,32,Arsenal Sarandi,26,21,11,10
2021,128,Liga Profesional Argentina,720277,2021-08-25T19:30:00+00:00,2nd Phase - 8,442,Defensa Y Justicia,457,Newells Old Boys,2,0,Defensa Y Justicia,2,47,Newells Old Boys,19,28,19,17
2021,128,Liga Profesional Argentina,720273,2021-08-25T19:30:00+00:00,2nd Phase - 8,446,Lanus,434,Gimnasia L.P.,2,0,Lanus,10,37,Gimnasia L.P.,11,36,1,1
2021,128,Liga Profesional Argentina,720272,2021-08-25T21:45:00+00:00,2nd Phase - 8,445,Huracan,438,Velez Sarsfield,1,1,Huracan,8,38,Velez Sarsfield,5,39,-1,-3
2021,128,Liga Profesional Argentina,720280,2021-08-26T00:00:00+00:00,2nd Phase - 8,1064,Platense,451,Boca Juniors,1,3,Platense,18,31,Boca Juniors,4,41,-10,-14
2021,128,Liga Profesional Argentina,720271,2021-08-26T17:15:00+00:00,2nd Phase - 8,439,Godoy Cruz,441,Union Santa Fe,1,2,Godoy Cruz,17,31,Union Santa Fe,12,34,-3,-5
2021,128,Liga Profesional Argentina,720283,2021-08-26T19:30:00+00:00,2nd Phase - 8,458,Argentinos JRS,456,Talleres Cordoba,1,2,Argentinos JRS,14,32,Talleres Cordoba,3,46,-14,-11
2021,128,Liga Profesional Argentina,720282,2021-08-26T21:45:00+00:00,2nd Phase - 8,450,Estudiantes L.P.,460,San Lorenzo,2,0,Estudiantes L.P.,6,39,San Lorenzo,21,27,12,15
2021,128,Liga Profesional Argentina,720274,2021-08-27T00:00:00+00:00,2nd Phase - 8,435,River Plate,463,Aldosivi,2,0,River Plate,1,54,Aldosivi,13,33,21,12
2021,128,Liga Profesional Argentina,720295,2021-08-28T18:45:00+00:00,2nd Phase - 9,434,Gimnasia L.P.,445,Huracan,0,0,Gimnasia L.P.,11,36,Huracan,8,38,-2,-3
2021,128,Liga Profesional Argentina,720287,2021-08-28T21:00:00+00:00,2nd Phase - 9,449,Banfield,1064,Platense,2,4,Banfield,20,27,Platense,18,31,-4,-2
2021,128,Liga Profesional Argentina,720292,2021-08-28T23:15:00+00:00,2nd Phase - 9,453,Independiente,448,Colon Santa Fe,3,0,Independiente,9,38,Colon Santa Fe,7,39,-1,-2
2021,128,Liga Profesional Argentina,720290,2021-08-29T16:30:00+00:00,2nd Phase - 9,459,Arsenal Sarandi,442,Defensa Y Justicia,0,0,Arsenal Sarandi,26,21,Defensa Y Justicia,2,47,-26,-24
2021,128,Liga Profesional Argentina,720294,2021-08-29T18:45:00+00:00,2nd Phase - 9,463,Aldosivi,446,Lanus,2,3,Aldosivi,13,33,Lanus,10,37,-4,-3
2021,128,Liga Profesional Argentina,720289,2021-08-29T18:45:00+00:00,2nd Phase - 9,1065,Central Cordoba de Santiago,437,Rosario Central,2,4,Central Cordoba de Santiago,22,26,Rosario Central,16,32,-6,-6
2021,128,Liga Profesional Argentina,720296,2021-08-29T21:00:00+00:00,2nd Phase - 9,438,Velez Sarsfield,439,Godoy Cruz,3,0,Velez Sarsfield,5,39,Godoy Cruz,17,31,8,12
2021,128,Liga Profesional Argentina,720288,2021-08-29T23:15:00+00:00,2nd Phase - 9,451,Boca Juniors,436,Racing Club,0,0,Boca Juniors,4,41,Racing Club,15,32,9,11
2021,128,Liga Profesional Argentina,720284,2021-08-30T17:30:00+00:00,2nd Phase - 9,441,Union Santa Fe,458,Argentinos JRS,1,0,Union Santa Fe,12,34,Argentinos JRS,14,32,2,2
2021,128,Liga Profesional Argentina,720291,2021-08-30T17:30:00+00:00,2nd Phase - 9,457,Newells Old Boys,455,Atletico Tucuman,1,2,Newells Old Boys,19,28,Atletico Tucuman,25,22,6,6
2021,128,Liga Profesional Argentina,720286,2021-08-30T19:45:00+00:00,2nd Phase - 9,460,San Lorenzo,444,Patronato,3,0,San Lorenzo,21,27,Patronato,23,25,2,2
2021,128,Liga Profesional Argentina,720293,2021-08-30T22:00:00+00:00,2nd Phase - 9,474,Sarmiento Junin,435,River Plate,1,2,Sarmiento Junin,24,24,River Plate,1,54,-30,-23
2021,128,Liga Profesional Argentina,720285,2021-08-31T00:15:00+00:00,2nd Phase - 9,456,Talleres Cordoba,450,Estudiantes L.P.,2,0,Talleres Cordoba,3,46,Estudiantes L.P.,6,39,7,3
2021,128,Liga Profesional Argentina,720304,2021-09-03T22:00:00+00:00,2nd Phase - 10,442,Defensa Y Justicia,1065,Central Cordoba de Santiago,1,1,Defensa Y Justicia,2,47,Central Cordoba de Santiago,22,26,21,20
2021,128,Liga Profesional Argentina,720299,2021-09-04T00:15:00+00:00,2nd Phase - 10,445,Huracan,463,Aldosivi,2,0,Huracan,8,38,Aldosivi,13,33,5,5
2021,128,Liga Profesional Argentina,720303,2021-09-04T16:30:00+00:00,2nd Phase - 10,455,Atletico Tucuman,459,Arsenal Sarandi,0,0,Atletico Tucuman,25,22,Arsenal Sarandi,26,21,1,1
2021,128,Liga Profesional Argentina,720300,2021-09-04T18:45:00+00:00,2nd Phase - 10,446,Lanus,474,Sarmiento Junin,1,1,Lanus,10,37,Sarmiento Junin,24,24,13,14
2021,128,Liga Profesional Argentina,720302,2021-09-04T18:45:00+00:00,2nd Phase - 10,448,Colon Santa Fe,457,Newells Old Boys,1,1,Colon Santa Fe,7,39,Newells Old Boys,19,28,11,12
2021,128,Liga Profesional Argentina,720307,2021-09-04T21:00:00+00:00,2nd Phase - 10,1064,Platense,460,San Lorenzo,1,1,Platense,18,31,San Lorenzo,21,27,4,3
2021,128,Liga Profesional Argentina,720305,2021-09-04T23:15:00+00:00,2nd Phase - 10,437,Rosario Central,451,Boca Juniors,1,2,Rosario Central,16,32,Boca Juniors,4,41,-9,-12
2021,128,Liga Profesional Argentina,720298,2021-09-05T16:30:00+00:00,2nd Phase - 10,439,Godoy Cruz,434,Gimnasia L.P.,4,0,Godoy Cruz,17,31,Gimnasia L.P.,11,36,-5,-6
2021,128,Liga Profesional Argentina,720308,2021-09-05T16:30:00+00:00,2nd Phase - 10,444,Patronato,456,Talleres Cordoba,0,0,Patronato,23,25,Talleres Cordoba,3,46,-21,-20
2021,128,Liga Profesional Argentina,720306,2021-09-05T22:00:00+00:00,2nd Phase - 10,436,Racing Club,449,Banfield,0,0,Racing Club,15,32,Banfield,20,27,5,5
2021,128,Liga Profesional Argentina,720301,2021-09-06T00:15:00+00:00,2nd Phase - 10,435,River Plate,453,Independiente,1,1,River Plate,1,54,Independiente,9,38,16,8
2021,128,Liga Profesional Argentina,720309,2021-09-06T21:00:00+00:00,2nd Phase - 10,450,Estudiantes L.P.,458,Argentinos JRS,1,1,Estudiantes L.P.,6,39,Argentinos JRS,14,32,7,8
2021,128,Liga Profesional Argentina,720297,2021-09-06T23:15:00+00:00,2nd Phase - 10,438,Velez Sarsfield,441,Union Santa Fe,4,0,Velez Sarsfield,5,39,Union Santa Fe,12,34,5,7
2021,128,Liga Profesional Argentina,720321,2021-09-13T17:15:00+00:00,2nd Phase - 11,463,Aldosivi,439,Godoy Cruz,1,4,Aldosivi,13,33,Godoy Cruz,17,31,2,4
2021,128,Liga Profesional Argentina,720320,2021-09-13T17:15:00+00:00,2nd Phase - 11,474,Sarmiento Junin,445,Huracan,0,0,Sarmiento Junin,24,24,Huracan,8,38,-14,-16
2021,128,Liga Profesional Argentina,720319,2021-09-13T19:30:00+00:00,2nd Phase - 11,453,Independiente,446,Lanus,0,1,Independiente,9,38,Lanus,10,37,1,1
2021,128,Liga Profesional Argentina,720313,2021-09-13T21:45:00+00:00,2nd Phase - 11,460,San Lorenzo,436,Racing Club,1,1,San Lorenzo,21,27,Racing Club,15,32,-5,-6
2021,128,Liga Profesional Argentina,720322,2021-09-14T00:00:00+00:00,2nd Phase - 11,434,Gimnasia L.P.,438,Velez Sarsfield,0,0,Gimnasia L.P.,11,36,Velez Sarsfield,5,39,-3,-6
2021,128,Liga Profesional Argentina,720312,2021-09-14T17:15:00+00:00,2nd Phase - 11,456,Talleres Cordoba,1064,Platense,2,1,Talleres Cordoba,3,46,Platense,18,31,15,15
2021,128,Liga Profesional Argentina,720317,2021-09-14T19:30:00+00:00,2nd Phase - 11,459,Arsenal Sarandi,448,Colon Santa Fe,0,0,Arsenal Sarandi,26,21,Colon Santa Fe,7,39,-18,-19
2021,128,Liga Profesional Argentina,720316,2021-09-14T21:45:00+00:00,2nd Phase - 11,1065,Central Cordoba de Santiago,455,Atletico Tucuman,2,0,Central Cordoba de Santiago,22,26,Atletico Tucuman,25,22,4,3
2021,128,Liga Profesional Argentina,720315,2021-09-15T00:00:00+00:00,2nd Phase - 11,451,Boca Juniors,442,Defensa Y Justicia,0,0,Boca Juniors,4,41,Defensa Y Justicia,2,47,-6,-2
2021,128,Liga Profesional Argentina,720310,2021-09-15T17:15:00+00:00,2nd Phase - 11,441,Union Santa Fe,450,Estudiantes L.P.,0,2,Union Santa Fe,12,34,Estudiantes L.P.,6,39,-5,-6
2021,128,Liga Profesional Argentina,720311,2021-09-15T19:30:00+00:00,2nd Phase - 11,458,Argentinos JRS,444,Patronato,1,1,Argentinos JRS,14,32,Patronato,23,25,7,9
2021,128,Liga Profesional Argentina,720314,2021-09-15T21:45:00+00:00,2nd Phase - 11,449,Banfield,437,Rosario Central,1,2,Banfield,20,27,Rosario Central,16,32,-5,-4
2021,128,Liga Profesional Argentina,720318,2021-09-16T00:00:00+00:00,2nd Phase - 11,457,Newells Old Boys,435,River Plate,1,4,Newells Old Boys,19,28,River Plate,1,54,-26,-18
2021,128,Liga Profesional Argentina,720325,2021-09-18T16:30:00+00:00,2nd Phase - 12,439,Godoy Cruz,474,Sarmiento Junin,1,1,Godoy Cruz,17,31,Sarmiento Junin,24,24,7,7
2021,128,Liga Profesional Argentina,720324,2021-09-18T18:45:00+00:00,2nd Phase - 12,438,Velez Sarsfield,463,Aldosivi,3,2,Velez Sarsfield,5,39,Aldosivi,13,33,6,8
2021,128,Liga Profesional Argentina,720333,2021-09-18T21:00:00+00:00,2nd Phase - 12,436,Racing Club,456,Talleres Cordoba,1,2,Racing Club,15,32,Talleres Cordoba,3,46,-14,-12
2021,128,Liga Profesional Argentina,720330,2021-09-18T23:15:00+00:00,2nd Phase - 12,455,Atletico Tucuman,451,Boca Juniors,1,2,Atletico Tucuman,25,22,Boca Juniors,4,41,-19,-21
2021,128,Liga Profesional Argentina,720335,2021-09-19T16:30:00+00:00,2nd Phase - 12,444,Patronato,450,Estudiantes L.P.,1,2,Patronato,23,25,Estudiantes L.P.,6,39,-14,-17
2021,128,Liga Profesional Argentina,720329,2021-09-19T18:45:00+00:00,2nd Phase - 12,448,Colon Santa Fe,1065,Central Cordoba de Santiago,1,0,Colon Santa Fe,7,39,Central Cordoba de Santiago,22,26,13,15
2021,128,Liga Profesional Argentina,720334,2021-09-19T18:45:00+00:00,2nd Phase - 12,1064,Platense,458,Argentinos JRS,0,0,Platense,18,31,Argentinos JRS,14,32,-1,-4
2021,128,Liga Profesional Argentina,720326,2021-09-19T21:00:00+00:00,2nd Phase - 12,445,Huracan,453,Independiente,0,1,Huracan,8,38,Independiente,9,38,0,1
2021,128,Liga Profesional Argentina,720328,2021-09-19T23:15:00+00:00,2nd Phase - 12,435,River Plate,459,Arsenal Sarandi,1,0,River Plate,1,54,Arsenal Sarandi,26,21,33,25
2021,128,Liga Profesional Argentina,720323,2021-09-20T16:30:00+00:00,2nd Phase - 12,434,Gimnasia L.P.,441,Union Santa Fe,1,0,Gimnasia L.P.,11,36,Union Santa Fe,12,34,2,1
2021,128,Liga Profesional Argentina,720327,2021-09-20T18:45:00+00:00,2nd Phase - 12,446,Lanus,457,Newells Old Boys,1,2,Lanus,10,37,Newells Old Boys,19,28,9,9
2021,128,Liga Profesional Argentina,720332,2021-09-20T21:00:00+00:00,2nd Phase - 12,437,Rosario Central,460,San Lorenzo,1,0,Rosario Central,16,32,San Lorenzo,21,27,5,5
2021,128,Liga Profesional Argentina,720331,2021-09-20T23:15:00+00:00,2nd Phase - 12,442,Defensa Y Justicia,449,Banfield,0,0,Defensa Y Justicia,2,47,Banfield,20,27,20,18
2021,128,Liga Profesional Argentina,720347,2021-09-24T22:00:00+00:00,2nd Phase - 13,474,Sarmiento Junin,438,Velez Sarsfield,0,1,Sarmiento Junin,24,24,Velez Sarsfield,5,39,-15,-19
2021,128,Liga Profesional Argentina,720337,2021-09-25T00:15:00+00:00,2nd Phase - 13,450,Estudiantes L.P.,1064,Platense,1,1,Estudiantes L.P.,6,39,Platense,18,31,8,12
2021,128,Liga Profesional Argentina,720348,2021-09-25T16:30:00+00:00,2nd Phase - 13,463,Aldosivi,434,Gimnasia L.P.,1,3,Aldosivi,13,33,Gimnasia L.P.,11,36,-3,-2
2021,128,Liga Profesional Argentina,720339,2021-09-25T18:45:00+00:00,2nd Phase - 13,456,Talleres Cordoba,437,Rosario Central,4,1,Talleres Cordoba,3,46,Rosario Central,16,32,14,13
2021,128,Liga Profesional Argentina,720344,2021-09-25T18:45:00+00:00,2nd Phase - 13,459,Arsenal Sarandi,446,Lanus,1,0,Arsenal Sarandi,26,21,Lanus,10,37,-16,-16
2021,128,Liga Profesional Argentina,720341,2021-09-25T21:00:00+00:00,2nd Phase - 13,449,Banfield,455,Atletico Tucuman,2,0,Banfield,20,27,Atletico Tucuman,25,22,5,5
2021,128,Liga Profesional Argentina,720343,2021-09-25T23:15:00+00:00,2nd Phase - 13,1065,Central Cordoba de Santiago,435,River Plate,1,3,Central Cordoba de Santiago,22,26,River Plate,1,54,-28,-21
2021,128,Liga Profesional Argentina,720336,2021-09-26T16:30:00+00:00,2nd Phase - 13,441,Union Santa Fe,444,Patronato,2,0,Union Santa Fe,12,34,Patronato,23,25,9,11
2021,128,Liga Profesional Argentina,720340,2021-09-26T18:45:00+00:00,2nd Phase - 13,460,San Lorenzo,442,Defensa Y Justicia,2,1,San Lorenzo,21,27,Defensa Y Justicia,2,47,-20,-19
2021,128,Liga Profesional Argentina,720346,2021-09-26T21:00:00+00:00,2nd Phase - 13,453,Independiente,439,Godoy Cruz,1,4,Independiente,9,38,Godoy Cruz,17,31,7,8
2021,128,Liga Profesional Argentina,720342,2021-09-26T23:15:00+00:00,2nd Phase - 13,451,Boca Juniors,448,Colon Santa Fe,1,0,Boca Juniors,4,41,Colon Santa Fe,7,39,2,3
2021,128,Liga Profesional Argentina,720338,2021-09-27T21:00:00+00:00,2nd Phase - 13,458,Argentinos JRS,436,Racing Club,2,0,Argentinos JRS,14,32,Racing Club,15,32,0,1
2021,128,Liga Profesional Argentina,720345,2021-09-27T23:15:00+00:00,2nd Phase - 13,457,Newells Old Boys,445,Huracan,0,1,Newells Old Boys,19,28,Huracan,8,38,-10,-11
2021,128,Liga Profesional Argentina,720349,2021-10-01T22:00:00+00:00,2nd Phase - 14,463,Aldosivi,441,Union Santa Fe,1,2,Aldosivi,13,33,Union Santa Fe,12,34,-1,-1
2021,128,Liga Profesional Argentina,720354,2021-10-02T00:15:00+00:00,2nd Phase - 14,446,Lanus,1065,Central Cordoba de Santiago,2,1,Lanus,10,37,Central Cordoba de Santiago,22,26,11,12
2021,128,Liga Profesional Argentina,720352,2021-10-02T16:30:00+00:00,2nd Phase - 14,439,Godoy Cruz,457,Newells Old Boys,2,2,Godoy Cruz,17,31,Newells Old Boys,19,28,3,2
2021,128,Liga Profesional Argentina,720361,2021-10-02T16:30:00+00:00,2nd Phase - 14,1064,Platense,444,Patronato,0,0,Platense,18,31,Patronato,23,25,6,5
2021,128,Liga Profesional Argentina,720353,2021-10-02T18:45:00+00:00,2nd Phase - 14,445,Huracan,459,Arsenal Sarandi,1,0,Huracan,8,38,Arsenal Sarandi,26,21,17,18
2021,128,Liga Profesional Argentina,720357,2021-10-02T21:00:00+00:00,2nd Phase - 14,455,Atletico Tucuman,460,San Lorenzo,0,0,Atletico Tucuman,25,22,San Lorenzo,21,27,-5,-4
2021,128,Liga Profesional Argentina,720351,2021-10-02T23:15:00+00:00,2nd Phase - 14,438,Velez Sarsfield,453,Independiente,3,3,Velez Sarsfield,5,39,Independiente,9,38,1,4
2021,128,Liga Profesional Argentina,720350,2021-10-03T16:30:00+00:00,2nd Phase - 14,434,Gimnasia L.P.,474,Sarmiento Junin,0,1,Gimnasia L.P.,11,36,Sarmiento Junin,24,24,12,13
2021,128,Liga Profesional Argentina,720359,2021-10-03T16:30:00+00:00,2nd Phase - 14,437,Rosario Central,458,Argentinos JRS,0,1,Rosario Central,16,32,Argentinos JRS,14,32,0,-2
2021,128,Liga Profesional Argentina,720355,2021-10-03T20:00:00+00:00,2nd Phase - 14,435,River Plate,451,Boca Juniors,2,1,River Plate,1,54,Boca Juniors,4,41,13,3
2021,128,Liga Profesional Argentina,720360,2021-10-03T23:15:00+00:00,2nd Phase - 14,436,Racing Club,450,Estudiantes L.P.,1,1,Racing Club,15,32,Estudiantes L.P.,6,39,-7,-9
2021,128,Liga Profesional Argentina,720358,2021-10-04T21:00:00+00:00,2nd Phase - 14,442,Defensa Y Justicia,456,Talleres Cordoba,3,0,Defensa Y Justicia,2,47,Talleres Cordoba,3,46,1,1
2021,128,Liga Profesional Argentina,720356,2021-10-04T23:15:00+00:00,2nd Phase - 14,448,Colon Santa Fe,449,Banfield,0,0,Colon Santa Fe,7,39,Banfield,20,27,12,13
2021,128,Liga Profesional Argentina,720362,2021-10-08T17:30:00+00:00,2nd Phase - 15,441,Union Santa Fe,1064,Platense,1,2,Union Santa Fe,12,34,Platense,18,31,3,6
2021,128,Liga Profesional Argentina,720370,2021-10-08T19:45:00+00:00,2nd Phase - 15,1065,Central Cordoba de Santiago,445,Huracan,1,2,Central Cordoba de Santiago,22,26,Huracan,8,38,-12,-14
2021,128,Liga Profesional Argentina,720364,2021-10-08T22:00:00+00:00,2nd Phase - 15,450,Estudiantes L.P.,437,Rosario Central,2,2,Estudiantes L.P.,6,39,Rosario Central,16,32,7,10
2021,128,Liga Profesional Argentina,720372,2021-10-09T00:15:00+00:00,2nd Phase - 15,457,Newells Old Boys,438,Velez Sarsfield,1,2,Newells Old Boys,19,28,Velez Sarsfield,5,39,-11,-14
2021,128,Liga Profesional Argentina,720365,2021-10-09T16:30:00+00:00,2nd Phase - 15,458,Argentinos JRS,442,Defensa Y Justicia,0,2,Argentinos JRS,14,32,Defensa Y Justicia,2,47,-15,-12
2021,128,Liga Profesional Argentina,720374,2021-10-09T16:30:00+00:00,2nd Phase - 15,474,Sarmiento Junin,463,Aldosivi,3,0,Sarmiento Junin,24,24,Aldosivi,13,33,-9,-11
2021,128,Liga Profesional Argentina,720363,2021-10-09T18:45:00+00:00,2nd Phase - 15,444,Patronato,436,Racing Club,1,2,Patronato,23,25,Racing Club,15,32,-7,-8
2021,128,Liga Profesional Argentina,720368,2021-10-09T21:00:00+00:00,2nd Phase - 15,449,Banfield,435,River Plate,0,1,Banfield,20,27,River Plate,1,54,-27,-19
2021,128,Liga Profesional Argentina,720369,2021-10-09T23:15:00+00:00,2nd Phase - 15,451,Boca Juniors,446,Lanus,4,2,Boca Juniors,4,41,Lanus,10,37,4,6
2021,128,Liga Profesional Argentina,720371,2021-10-11T17:30:00+00:00,2nd Phase - 15,459,Arsenal Sarandi,439,Godoy Cruz,0,0,Arsenal Sarandi,26,21,Godoy Cruz,17,31,-10,-9
2021,128,Liga Profesional Argentina,720367,2021-10-11T19:45:00+00:00,2nd Phase - 15,460,San Lorenzo,448,Colon Santa Fe,1,2,San Lorenzo,21,27,Colon Santa Fe,7,39,-12,-14
2021,128,Liga Profesional Argentina,720373,2021-10-11T22:00:00+00:00,2nd Phase - 15,453,Independiente,434,Gimnasia L.P.,1,1,Independiente,9,38,Gimnasia L.P.,11,36,2,2
2021,128,Liga Profesional Argentina,720366,2021-10-12T00:15:00+00:00,2nd Phase - 15,456,Talleres Cordoba,455,Atletico Tucuman,2,0,Talleres Cordoba,3,46,Atletico Tucuman,25,22,24,22
2021,128,Liga Profesional Argentina,720379,2021-10-15T17:30:00+00:00,2nd Phase - 16,439,Godoy Cruz,1065,Central Cordoba de Santiago,0,0,Godoy Cruz,17,31,Central Cordoba de Santiago,22,26,5,5
2021,128,Liga Profesional Argentina,720386,2021-10-15T19:45:00+00:00,2nd Phase - 16,437,Rosario Central,444,Patronato,3,2,Rosario Central,16,32,Patronato,23,25,7,7
2021,128,Liga Profesional Argentina,720387,2021-10-15T22:00:00+00:00,2nd Phase - 16,436,Racing Club,1064,Platense,0,1,Racing Club,15,32,Platense,18,31,1,3
2021,128,Liga Profesional Argentina,720378,2021-10-16T00:15:00+00:00,2nd Phase - 16,438,Velez Sarsfield,459,Arsenal Sarandi,0,0,Velez Sarsfield,5,39,Arsenal Sarandi,26,21,18,21
2021,128,Liga Profesional Argentina,720385,2021-10-16T00:15:00+00:00,2nd Phase - 16,442,Defensa Y Justicia,450,Estudiantes L.P.,2,1,Defensa Y Justicia,2,47,Estudiantes L.P.,6,39,8,4
2021,128,Liga Profesional Argentina,720375,2021-10-16T16:30:00+00:00,2nd Phase - 16,474,Sarmiento Junin,441,Union Santa Fe,3,4,Sarmiento Junin,24,24,Union Santa Fe,12,34,-10,-12
2021,128,Liga Profesional Argentina,720377,2021-10-16T18:45:00+00:00,2nd Phase - 16,434,Gimnasia L.P.,457,Newells Old Boys,1,0,Gimnasia L.P.,11,36,Newells Old Boys,19,28,8,8
2021,128,Liga Profesional Argentina,720381,2021-10-16T21:00:00+00:00,2nd Phase - 16,446,Lanus,449,Banfield,1,1,Lanus,10,37,Banfield,20,27,10,10
2021,128,Liga Profesional Argentina,720380,2021-10-16T23:15:00+00:00,2nd Phase - 16,445,Huracan,451,Boca Juniors,0,3,Huracan,8,38,Boca Juniors,4,41,-3,-4
2021,128,Liga Profesional Argentina,720383,2021-10-17T18:45:00+00:00,2nd Phase - 16,448,Colon Santa Fe,456,Talleres Cordoba,1,0,Colon Santa Fe,7,39,Talleres Cordoba,3,46,-7,-4
2021,128,Liga Profesional Argentina,720384,2021-10-17T18:45:00+00:00,2nd Phase - 16,455,Atletico Tucuman,458,Argentinos JRS,4,3,Atletico Tucuman,25,22,Argentinos JRS,14,32,-10,-11
2021,128,Liga Profesional Argentina,720376,2021-10-17T21:00:00+00:00,2nd Phase - 16,463,Aldosivi,453,Independiente,1,0,Aldosivi,13,33,Independiente,9,38,-5,-4
2021,128,Liga Profesional Argentina,720382,2021-10-17T23:15:00+00:00,2nd Phase - 16,435,River Plate,460,San Lorenzo,3,1,River Plate,1,54,San Lorenzo,21,27,27,20
2021,128,Liga Profesional Argentina,720389,2021-10-19T17:30:00+00:00,2nd Phase - 17,1064,Platense,437,Rosario Central,1,1,Platense,18,31,Rosario Central,16,32,-1,-2
2021,128,Liga Profesional Argentina,720388,2021-10-19T19:45:00+00:00,2nd Phase - 17,441,Union Santa Fe,436,Racing Club,1,1,Union Santa Fe,12,34,Racing Club,15,32,2,3
2021,128,Liga Profesional Argentina,720390,2021-10-19T22:00:00+00:00,2nd Phase - 17,444,Patronato,442,Defensa Y Justicia,3,3,Patronato,23,25,Defensa Y Justicia,2,47,-22,-21
2021,128,Liga Profesional Argentina,720397,2021-10-20T00:15:00+00:00,2nd Phase - 17,1065,Central Cordoba de Santiago,438,Velez Sarsfield,1,2,Central Cordoba de Santiago,22,26,Velez Sarsfield,5,39,-13,-17
2021,128,Liga Profesional Argentina,720398,2021-10-20T17:30:00+00:00,2nd Phase - 17,459,Arsenal Sarandi,434,Gimnasia L.P.,0,1,Arsenal Sarandi,26,21,Gimnasia L.P.,11,36,-15,-15
2021,128,Liga Profesional Argentina,720394,2021-10-20T19:45:00+00:00,2nd Phase - 17,460,San Lorenzo,446,Lanus,1,3,San Lorenzo,21,27,Lanus,10,37,-10,-11
2021,128,Liga Profesional Argentina,720395,2021-10-20T22:00:00+00:00,2nd Phase - 17,449,Banfield,445,Huracan,1,4,Banfield,20,27,Huracan,8,38,-11,-12
2021,128,Liga Profesional Argentina,720391,2021-10-20T22:00:00+00:00,2nd Phase - 17,450,Estudiantes L.P.,455,Atletico Tucuman,1,1,Estudiantes L.P.,6,39,Atletico Tucuman,25,22,17,19
2021,128,Liga Profesional Argentina,720396,2021-10-21T00:15:00+00:00,2nd Phase - 17,451,Boca Juniors,439,Godoy Cruz,2,1,Boca Juniors,4,41,Godoy Cruz,17,31,10,13
2021,128,Liga Profesional Argentina,720392,2021-10-21T17:30:00+00:00,2nd Phase - 17,458,Argentinos JRS,448,Colon Santa Fe,3,1,Argentinos JRS,14,32,Colon Santa Fe,7,39,-7,-7
2021,128,Liga Profesional Argentina,720399,2021-10-21T19:45:00+00:00,2nd Phase - 17,457,Newells Old Boys,463,Aldosivi,0,0,Newells Old Boys,19,28,Aldosivi,13,33,-5,-6
2021,128,Liga Profesional Argentina,720400,2021-10-21T22:00:00+00:00,2nd Phase - 17,453,Independiente,474,Sarmiento Junin,1,1,Independiente,9,38,Sarmiento Junin,24,24,14,15
2021,128,Liga Profesional Argentina,720393,2021-10-22T00:15:00+00:00,2nd Phase - 17,456,Talleres Cordoba,435,River Plate,0,2,Talleres Cordoba,3,46,River Plate,1,54,-8,-2
2021,128,Liga Profesional Argentina,720404,2021-10-23T18:45:00+00:00,2nd Phase - 18,434,Gimnasia L.P.,1065,Central Cordoba de Santiago,2,2,Gimnasia L.P.,11,36,Central Cordoba de Santiago,22,26,10,11
2021,128,Liga Profesional Argentina,720412,2021-10-23T21:00:00+00:00,2nd Phase - 18,442,Defensa Y Justicia,1064,Platense,2,1,Defensa Y Justicia,2,47,Platense,18,31,16,16
2021,128,Liga Profesional Argentina,720413,2021-10-23T23:15:00+00:00,2nd Phase - 18,437,Rosario Central,436,Racing Club,2,1,Rosario Central,16,32,Racing Club,15,32,0,-1
2021,128,Liga Profesional Argentina,720406,2021-10-24T18:45:00+00:00,2nd Phase - 18,439,Godoy Cruz,449,Banfield,2,1,Godoy Cruz,17,31,Banfield,20,27,4,3
2021,128,Liga Profesional Argentina,720410,2021-10-24T18:45:00+00:00,2nd Phase - 18,448,Colon Santa Fe,450,Estudiantes L.P.,2,1,Colon Santa Fe,7,39,Estudiantes L.P.,6,39,0,-1
2021,128,Liga Profesional Argentina,720407,2021-10-24T21:00:00+00:00,2nd Phase - 18,445,Huracan,460,San Lorenzo,2,1,Huracan,8,38,San Lorenzo,21,27,11,13
2021,128,Liga Profesional Argentina,720405,2021-10-24T23:15:00+00:00,2nd Phase - 18,438,Velez Sarsfield,451,Boca Juniors,2,0,Velez Sarsfield,5,39,Boca Juniors,4,41,-2,-1
2021,128,Liga Profesional Argentina,720403,2021-10-25T17:30:00+00:00,2nd Phase - 18,463,Aldosivi,459,Arsenal Sarandi,2,1,Aldosivi,13,33,Arsenal Sarandi,26,21,12,13
2021,128,Liga Profesional Argentina,720402,2021-10-25T17:30:00+00:00,2nd Phase - 18,474,Sarmiento Junin,457,Newells Old Boys,2,1,Sarmiento Junin,24,24,Newells Old Boys,19,28,-4,-5
2021,128,Liga Profesional Argentina,720408,2021-10-25T19:45:00+00:00,2nd Phase - 18,446,Lanus,456,Talleres Cordoba,3,3,Lanus,10,37,Talleres Cordoba,3,46,-9,-7
2021,128,Liga Profesional Argentina,720411,2021-10-25T19:45:00+00:00,2nd Phase - 18,455,Atletico Tucuman,444,Patronato,2,2,Atletico Tucuman,25,22,Patronato,23,25,-3,-2
2021,128,Liga Profesional Argentina,720409,2021-10-25T22:00:00+00:00,2nd Phase - 18,435,River Plate,458,Argentinos JRS,3,0,River Plate,1,54,Argentinos JRS,14,32,22,13
2021,128,Liga Profesional Argentina,720401,2021-10-26T00:15:00+00:00,2nd Phase - 18,453,Independiente,441,Union Santa Fe,1,0,Independiente,9,38,Union Santa Fe,12,34,4,3
2021,128,Liga Profesional Argentina,720415,2021-10-29T22:00:00+00:00,2nd Phase - 19,436,Racing Club,442,Defensa Y Justicia,1,2,Racing Club,15,32,Defensa Y Justicia,2,47,-15,-13
2021,128,Liga Profesional Argentina,720419,2021-10-30T00:15:00+00:00,2nd Phase - 19,458,Argentinos JRS,446,Lanus,0,1,Argentinos JRS,14,32,Lanus,10,37,-5,-4
2021,128,Liga Profesional Argentina,720425,2021-10-30T18:45:00+00:00,2nd Phase - 19,459,Arsenal Sarandi,474,Sarmiento Junin,1,0,Arsenal Sarandi,26,21,Sarmiento Junin,24,24,-3,-2
2021,128,Liga Profesional Argentina,720416,2021-10-30T18:45:00+00:00,2nd Phase - 19,1064,Platense,455,Atletico Tucuman,4,1,Platense,18,31,Atletico Tucuman,25,22,9,7
2021,128,Liga Profesional Argentina,720422,2021-10-30T21:00:00+00:00,2nd Phase - 19,449,Banfield,438,Velez Sarsfield,2,1,Banfield,20,27,Velez Sarsfield,5,39,-12,-15
2021,128,Liga Profesional Argentina,720420,2021-10-30T21:00:00+00:00,2nd Phase - 19,456,Talleres Cordoba,445,Huracan,1,0,Talleres Cordoba,3,46,Huracan,8,38,8,5
2021,128,Liga Profesional Argentina,720423,2021-10-31T00:15:00+00:00,2nd Phase - 19,451,Boca Juniors,434,Gimnasia L.P.,0,1,Boca Juniors,4,41,Gimnasia L.P.,11,36,5,7
2021,128,Liga Profesional Argentina,720414,2021-10-31T18:45:00+00:00,2nd Phase - 19,441,Union Santa Fe,437,Rosario Central,3,1,Union Santa Fe,12,34,Rosario Central,16,32,2,4
2021,128,Liga Profesional Argentina,720421,2021-10-31T18:45:00+00:00,2nd Phase - 19,460,San Lorenzo,439,Godoy Cruz,1,0,San Lorenzo,21,27,Godoy Cruz,17,31,-4,-4
2021,128,Liga Profesional Argentina,720426,2021-10-31T21:00:00+00:00,2nd Phase - 19,457,Newells Old Boys,453,Independiente,1,0,Newells Old Boys,19,28,Independiente,9,38,-10,-10
2021,128,Liga Profesional Argentina,720417,2021-10-31T22:00:00+00:00,2nd Phase - 19,444,Patronato,448,Colon Santa Fe,2,0,Patronato,23,25,Colon Santa Fe,7,39,-14,-16
2021,128,Liga Profesional Argentina,720418,2021-10-31T23:15:00+00:00,2nd Phase - 19,450,Estudiantes L.P.,435,River Plate,1,1,Estudiantes L.P.,6,39,River Plate,1,54,-15,-5
2021,128,Liga Profesional Argentina,720424,2021-11-02T00:15:00+00:00,2nd Phase - 19,1065,Central Cordoba de Santiago,463,Aldosivi,0,0,Central Cordoba de Santiago,22,26,Aldosivi,13,33,-7,-9
2021,128,Liga Profesional Argentina,720439,2021-11-05T22:00:00+00:00,2nd Phase - 20,442,Defensa Y Justicia,437,Rosario Central,3,0,Defensa Y Justicia,2,47,Rosario Central,16,32,15,14
2021,128,Liga Profesional Argentina,720435,2021-11-06T00:15:00+00:00,2nd Phase - 20,446,Lanus,450,Estudiantes L.P.,1,1,Lanus,10,37,Estudiantes L.P.,6,39,-2,-4
2021,128,Liga Profesional Argentina,720433,2021-11-06T18:45:00+00:00,2nd Phase - 20,439,Godoy Cruz,456,Talleres Cordoba,0,2,Godoy Cruz,17,31,Talleres Cordoba,3,46,-15,-14
2021,128,Liga Profesional Argentina,720437,2021-11-06T18:45:00+00:00,2nd Phase - 20,448,Colon Santa Fe,1064,Platense,3,0,Colon Santa Fe,7,39,Platense,18,31,8,11
2021,128,Liga Profesional Argentina,720428,2021-11-06T21:00:00+00:00,2nd Phase - 20,453,Independiente,459,Arsenal Sarandi,3,0,Independiente,9,38,Arsenal Sarandi,26,21,17,17
2021,128,Liga Profesional Argentina,720438,2021-11-06T23:15:00+00:00,2nd Phase - 20,455,Atletico Tucuman,436,Racing Club,0,2,Atletico Tucuman,25,22,Racing Club,15,32,-10,-10
2021,128,Liga Profesional Argentina,720431,2021-11-07T18:45:00+00:00,2nd Phase - 20,434,Gimnasia L.P.,449,Banfield,0,1,Gimnasia L.P.,11,36,Banfield,20,27,9,9
2021,128,Liga Profesional Argentina,720429,2021-11-07T18:45:00+00:00,2nd Phase - 20,474,Sarmiento Junin,1065,Central Cordoba de Santiago,1,3,Sarmiento Junin,24,24,Central Cordoba de Santiago,22,26,-2,-2
2021,128,Liga Profesional Argentina,720432,2021-11-07T21:00:00+00:00,2nd Phase - 20,438,Velez Sarsfield,460,San Lorenzo,2,1,Velez Sarsfield,5,39,San Lorenzo,21,27,12,16
2021,128,Liga Profesional Argentina,720436,2021-11-07T23:15:00+00:00,2nd Phase - 20,435,River Plate,444,Patronato,5,0,River Plate,1,54,Patronato,23,25,29,22
2021,128,Liga Profesional Argentina,720427,2021-11-08T19:45:00+00:00,2nd Phase - 20,457,Newells Old Boys,441,Union Santa Fe,1,0,Newells Old Boys,19,28,Union Santa Fe,12,34,-6,-7
2021,128,Liga Profesional Argentina,720434,2021-11-08T22:00:00+00:00,2nd Phase - 20,445,Huracan,458,Argentinos JRS,1,1,Huracan,8,38,Argentinos JRS,14,32,6,6
2021,128,Liga Profesional Argentina,720430,2021-11-09T00:15:00+00:00,2nd Phase - 20,463,Aldosivi,451,Boca Juniors,0,3,Aldosivi,13,33,Boca Juniors,4,41,-8,-9
2021,128,Liga Profesional Argentina,720440,2021-11-18T20:00:00+00:00,2nd Phase - 21,441,Union Santa Fe,442,Defensa Y Justicia,2,3,Union Santa Fe,12,34,Defensa Y Justicia,2,47,-13,-10
2021,128,Liga Profesional Argentina,720444,2021-11-18T22:15:00+00:00,2nd Phase - 21,444,Patronato,446,Lanus,3,2,Patronato,23,25,Lanus,10,37,-12,-13
2021,128,Liga Profesional Argentina,720449,2021-11-19T00:30:00+00:00,2nd Phase - 21,449,Banfield,463,Aldosivi,0,2,Banfield,20,27,Aldosivi,13,33,-6,-7
2021,128,Liga Profesional Argentina,720445,2021-11-19T20:00:00+00:00,2nd Phase - 21,450,Estudiantes L.P.,445,Huracan,4,1,Estudiantes L.P.,6,39,Huracan,8,38,1,2
2021,128,Liga Profesional Argentina,720448,2021-11-19T22:15:00+00:00,2nd Phase - 21,460,San Lorenzo,434,Gimnasia L.P.,0,1,San Lorenzo,21,27,Gimnasia L.P.,11,36,-9,-10
2021,128,Liga Profesional Argentina,720447,2021-11-20T00:30:00+00:00,2nd Phase - 21,456,Talleres Cordoba,438,Velez Sarsfield,1,1,Talleres Cordoba,3,46,Velez Sarsfield,5,39,7,2
2021,128,Liga Profesional Argentina,720446,2021-11-20T00:30:00+00:00,2nd Phase - 21,458,Argentinos JRS,439,Godoy Cruz,0,0,Argentinos JRS,14,32,Godoy Cruz,17,31,1,3
2021,128,Liga Profesional Argentina,720441,2021-11-20T20:00:00+00:00,2nd Phase - 21,437,Rosario Central,455,Atletico Tucuman,3,1,Rosario Central,16,32,Atletico Tucuman,25,22,10,9
2021,128,Liga Profesional Argentina,720450,2021-11-20T22:15:00+00:00,2nd Phase - 21,451,Boca Juniors,474,Sarmiento Junin,2,0,Boca Juniors,4,41,Sarmiento Junin,24,24,17,20
2021,128,Liga Profesional Argentina,720451,2021-11-21T00:30:00+00:00,2nd Phase - 21,1065,Central Cordoba de Santiago,453,Independiente,1,0,Central Cordoba de Santiago,22,26,Independiente,9,38,-12,-13
2021,128,Liga Profesional Argentina,720452,2021-11-21T20:00:00+00:00,2nd Phase - 21,459,Arsenal Sarandi,457,Newells Old Boys,3,1,Arsenal Sarandi,26,21,Newells Old Boys,19,28,-7,-7
2021,128,Liga Profesional Argentina,720442,2021-11-21T22:15:00+00:00,2nd Phase - 21,436,Racing Club,448,Colon Santa Fe,1,2,Racing Club,15,32,Colon Santa Fe,7,39,-7,-8
2021,128,Liga Profesional Argentina,720443,2021-11-22T00:30:00+00:00,2nd Phase - 21,1064,Platense,435,River Plate,0,1,Platense,18,31,River Plate,1,54,-23,-17
2021,128,Liga Profesional Argentina,720458,2021-11-23T20:00:00+00:00,2nd Phase - 22,434,Gimnasia L.P.,456,Talleres Cordoba,5,2,Gimnasia L.P.,11,36,Talleres Cordoba,3,46,-10,-8
2021,128,Liga Profesional Argentina,720461,2021-11-23T20:00:00+00:00,2nd Phase - 22,445,Huracan,444,Patronato,1,0,Huracan,8,38,Patronato,23,25,13,15
2021,128,Liga Profesional Argentina,720457,2021-11-23T22:15:00+00:00,2nd Phase - 22,463,Aldosivi,460,San Lorenzo,2,0,Aldosivi,13,33,San Lorenzo,21,27,6,8
2021,128,Liga Profesional Argentina,720459,2021-11-24T00:30:00+00:00,2nd Phase - 22,438,Velez Sarsfield,458,Argentinos JRS,2,0,Velez Sarsfield,5,39,Argentinos JRS,14,32,7,9
2021,128,Liga Profesional Argentina,720460,2021-11-24T00:30:00+00:00,2nd Phase - 22,439,Godoy Cruz,450,Estudiantes L.P.,1,3,Godoy Cruz,17,31,Estudiantes L.P.,6,39,-8,-11
2021,128,Liga Profesional Argentina,720454,2021-11-24T20:00:00+00:00,2nd Phase - 22,457,Newells Old Boys,1065,Central Cordoba de Santiago,1,0,Newells Old Boys,19,28,Central Cordoba de Santiago,22,26,2,3
2021,128,Liga Profesional Argentina,720456,2021-11-24T20:00:00+00:00,2nd Phase - 22,474,Sarmiento Junin,449,Banfield,0,0,Sarmiento Junin,24,24,Banfield,20,27,-3,-4
2021,128,Liga Profesional Argentina,720465,2021-11-24T22:15:00+00:00,2nd Phase - 22,455,Atletico Tucuman,442,Defensa Y Justicia,0,4,Atletico Tucuman,25,22,Defensa Y Justicia,2,47,-25,-23
2021,128,Liga Profesional Argentina,720455,2021-11-25T00:30:00+00:00,2nd Phase - 22,453,Independiente,451,Boca Juniors,1,0,Independiente,9,38,Boca Juniors,4,41,-3,-5
2021,128,Liga Profesional Argentina,720453,2021-11-25T20:00:00+00:00,2nd Phase - 22,459,Arsenal Sarandi,441,Union Santa Fe,0,1,Arsenal Sarandi,26,21,Union Santa Fe,12,34,-13,-14
2021,128,Liga Profesional Argentina,720462,2021-11-25T22:15:00+00:00,2nd Phase - 22,446,Lanus,1064,Platense,3,3,Lanus,10,37,Platense,18,31,6,8
2021,128,Liga Profesional Argentina,720464,2021-11-25T22:15:00+00:00,2nd Phase - 22,448,Colon Santa Fe,437,Rosario Central,1,4,Colon Santa Fe,7,39,Rosario Central,16,32,7,9
2021,128,Liga Profesional Argentina,720463,2021-11-26T00:30:00+00:00,2nd Phase - 22,435,River Plate,436,Racing Club,4,0,River Plate,1,54,Racing Club,15,32,22,14
2021,128,Liga Profesional Argentina,720474,2021-11-27T20:00:00+00:00,2nd Phase - 23,456,Talleres Cordoba,463,Aldosivi,2,0,Talleres Cordoba,3,46,Aldosivi,13,33,13,10
2021,128,Liga Profesional Argentina,720471,2021-11-27T22:15:00+00:00,2nd Phase - 23,444,Patronato,439,Godoy Cruz,0,3,Patronato,23,25,Godoy Cruz,17,31,-6,-6
2021,128,Liga Profesional Argentina,720472,2021-11-28T00:30:00+00:00,2nd Phase - 23,450,Estudiantes L.P.,438,Velez Sarsfield,1,0,Estudiantes L.P.,6,39,Velez Sarsfield,5,39,0,-1
2021,128,Liga Profesional Argentina,720468,2021-11-28T20:00:00+00:00,2nd Phase - 23,437,Rosario Central,435,River Plate,2,2,Rosario Central,16,32,River Plate,1,54,-22,-15
2021,128,Liga Profesional Argentina,720467,2021-11-28T22:15:00+00:00,2nd Phase - 23,442,Defensa Y Justicia,448,Colon Santa Fe,1,1,Defensa Y Justicia,2,47,Colon Santa Fe,7,39,8,5
2021,128,Liga Profesional Argentina,720473,2021-11-28T22:15:00+00:00,2nd Phase - 23,458,Argentinos JRS,434,Gimnasia L.P.,3,0,Argentinos JRS,14,32,Gimnasia L.P.,11,36,-4,-3
2021,128,Liga Profesional Argentina,720466,2021-11-29T20:00:00+00:00,2nd Phase - 23,441,Union Santa Fe,455,Atletico Tucuman,3,0,Union Santa Fe,12,34,Atletico Tucuman,25,22,12,13
2021,128,Liga Profesional Argentina,720469,2021-11-29T22:15:00+00:00,2nd Phase - 23,436,Racing Club,446,Lanus,3,1,Racing Club,15,32,Lanus,10,37,-5,-5
2021,128,Liga Profesional Argentina,720470,2021-11-30T00:30:00+00:00,2nd Phase - 23,1064,Platense,445,Huracan,4,2,Platense,18,31,Huracan,8,38,-7,-10
2021,128,Liga Profesional Argentina,720478,2021-11-30T00:30:00+00:00,2nd Phase - 23,1065,Central Cordoba de Santiago,459,Arsenal Sarandi,5,0,Central Cordoba de Santiago,22,26,Arsenal Sarandi,26,21,5,4
2021,128,Liga Profesional Argentina,720475,2021-11-30T20:00:00+00:00,2nd Phase - 23,460,San Lorenzo,474,Sarmiento Junin,1,0,San Lorenzo,21,27,Sarmiento Junin,24,24,3,3
2021,128,Liga Profesional Argentina,720477,2021-11-30T22:15:00+00:00,2nd Phase - 23,451,Boca Juniors,457,Newells Old Boys,0,0,Boca Juniors,4,41,Newells Old Boys,19,28,13,15
2021,128,Liga Profesional Argentina,720476,2021-12-01T00:30:00+00:00,2nd Phase - 23,449,Banfield,453,Independiente,4,1,Banfield,20,27,Independiente,9,38,-11,-11
2021,128,Liga Profesional Argentina,720491,2021-12-03T22:15:00+00:00,2nd Phase - 24,448,Colon Santa Fe,455,Atletico Tucuman,3,0,Colon Santa Fe,7,39,Atletico Tucuman,25,22,17,18
2021,128,Liga Profesional Argentina,720479,2021-12-03T22:15:00+00:00,2nd Phase - 24,1065,Central Cordoba de Santiago,441,Union Santa Fe,2,0,Central Cordoba de Santiago,22,26,Union Santa Fe,12,34,-8,-10
2021,128,Liga Profesional Argentina,720486,2021-12-04T00:30:00+00:00,2nd Phase - 24,438,Velez Sarsfield,444,Patronato,0,0,Velez Sarsfield,5,39,Patronato,23,25,14,18
2021,128,Liga Profesional Argentina,720480,2021-12-04T20:00:00+00:00,2nd Phase - 24,459,Arsenal Sarandi,451,Boca Juniors,1,1,Arsenal Sarandi,26,21,Boca Juniors,4,41,-20,-22
2021,128,Liga Profesional Argentina,720487,2021-12-04T22:15:00+00:00,2nd Phase - 24,439,Godoy Cruz,1064,Platense,2,2,Godoy Cruz,17,31,Platense,18,31,0,1
2021,128,Liga Profesional Argentina,720483,2021-12-04T22:15:00+00:00,2nd Phase - 24,474,Sarmiento Junin,456,Talleres Cordoba,1,2,Sarmiento Junin,24,24,Talleres Cordoba,3,46,-22,-21
2021,128,Liga Profesional Argentina,720488,2021-12-05T00:30:00+00:00,2nd Phase - 24,445,Huracan,436,Racing Club,1,0,Huracan,8,38,Racing Club,15,32,6,7
2021,128,Liga Profesional Argentina,720489,2021-12-05T00:30:00+00:00,2nd Phase - 24,446,Lanus,437,Rosario Central,2,2,Lanus,10,37,Rosario Central,16,32,5,6
2021,128,Liga Profesional Argentina,720485,2021-12-05T20:00:00+00:00,2nd Phase - 24,434,Gimnasia L.P.,450,Estudiantes L.P.,4,4,Gimnasia L.P.,11,36,Estudiantes L.P.,6,39,-3,-5
2021,128,Liga Profesional Argentina,720482,2021-12-05T22:15:00+00:00,2nd Phase - 24,453,Independiente,460,San Lorenzo,1,1,Independiente,9,38,San Lorenzo,21,27,11,12
2021,128,Liga Profesional Argentina,720490,2021-12-06T00:30:00+00:00,2nd Phase - 24,435,River Plate,442,Defensa Y Justicia,2,3,River Plate,1,54,Defensa Y Justicia,2,47,7,1
2021,128,Liga Profesional Argentina,720484,2021-12-06T22:15:00+00:00,2nd Phase - 24,463,Aldosivi,458,Argentinos JRS,3,2,Aldosivi,13,33,Argentinos JRS,14,32,1,1
2021,128,Liga Profesional Argentina,720481,2021-12-07T00:30:00+00:00,2nd Phase - 24,457,Newells Old Boys,449,Banfield,0,0,Newells Old Boys,19,28,Banfield,20,27,1,1
2021,128,Liga Profesional Argentina,720497,2021-12-10T22:15:00+00:00,2nd Phase - 25,1064,Platense,438,Velez Sarsfield,3,2,Platense,18,31,Velez Sarsfield,5,39,-8,-13
2021,128,Liga Profesional Argentina,720499,2021-12-11T00:30:00+00:00,2nd Phase - 25,450,Estudiantes L.P.,463,Aldosivi,2,3,Estudiantes L.P.,6,39,Aldosivi,13,33,6,7
2021,128,Liga Profesional Argentina,720496,2021-12-11T20:00:00+00:00,2nd Phase - 25,436,Racing Club,439,Godoy Cruz,2,1,Racing Club,15,32,Godoy Cruz,17,31,1,2
2021,128,Liga Profesional Argentina,720495,2021-12-11T20:00:00+00:00,2nd Phase - 25,437,Rosario Central,445,Huracan,1,4,Rosario Central,16,32,Huracan,8,38,-6,-8
2021,128,Liga Profesional Argentina,720492,2021-12-11T20:00:00+00:00,2nd Phase - 25,441,Union Santa Fe,448,Colon Santa Fe,3,0,Union Santa Fe,12,34,Colon Santa Fe,7,39,-5,-5
2021,128,Liga Profesional Argentina,720498,2021-12-11T20:00:00+00:00,2nd Phase - 25,444,Patronato,434,Gimnasia L.P.,0,0,Patronato,23,25,Gimnasia L.P.,11,36,-11,-12
2021,128,Liga Profesional Argentina,720500,2021-12-11T20:00:00+00:00,2nd Phase - 25,458,Argentinos JRS,474,Sarmiento Junin,2,0,Argentinos JRS,14,32,Sarmiento Junin,24,24,8,10
2021,128,Liga Profesional Argentina,720493,2021-12-11T22:15:00+00:00,2nd Phase - 25,455,Atletico Tucuman,435,River Plate,1,1,Atletico Tucuman,25,22,River Plate,1,54,-32,-24
2021,128,Liga Profesional Argentina,720504,2021-12-12T01:00:00+00:00,2nd Phase - 25,451,Boca Juniors,1065,Central Cordoba de Santiago,8,1,Boca Juniors,4,41,Central Cordoba de Santiago,22,26,15,18
2021,128,Liga Profesional Argentina,720502,2021-12-12T20:00:00+00:00,2nd Phase - 25,460,San Lorenzo,457,Newells Old Boys,3,2,San Lorenzo,21,27,Newells Old Boys,19,28,-1,-2
2021,128,Liga Profesional Argentina,720494,2021-12-12T22:15:00+00:00,2nd Phase - 25,442,Defensa Y Justicia,446,Lanus,2,1,Defensa Y Justicia,2,47,Lanus,10,37,10,8
2021,128,Liga Profesional Argentina,720501,2021-12-13T00:30:00+00:00,2nd Phase - 25,456,Talleres Cordoba,453,Independiente,1,2,Talleres Cordoba,3,46,Independiente,9,38,8,6
2021,128,Liga Profesional Argentina,720503,2021-12-13T23:00:00+00:00,2nd Phase - 25,449,Banfield,459,Arsenal Sarandi,0,0,Banfield,20,27,Arsenal Sarandi,26,21,6,6
2022,128,Liga Profesional Argentina,831664,2022-02-10T22:15:00+00:00,1st Phase - 1,444,Patronato,458,Argentinos JRS,0,1,Patronato,10,40,Argentinos JRS,8,42,-2,-2
2022,128,Liga Profesional Argentina,831665,2022-02-10T22:15:00+00:00,1st Phase - 1,474,Sarmiento Junin,455,Atletico Tucuman,1,0,Sarmiento Junin,21,32,Atletico Tucuman,5,46,-14,-16
2022,128,Liga Profesional Argentina,831666,2022-02-11T00:30:00+00:00,1st Phase - 1,457,Newells Old Boys,442,Defensa Y Justicia,1,0,Newells Old Boys,11,40,Defensa Y Justicia,12,40,0,1
2022,128,Liga Profesional Argentina,831667,2022-02-11T00:30:00+00:00,1st Phase - 1,1065,Central Cordoba de Santiago,2432,Barracas Central,3,1,Central Cordoba de Santiago,16,34,Barracas Central,17,34,0,1
2022,128,Liga Profesional Argentina,831668,2022-02-11T20:00:00+00:00,1st Phase - 1,459,Arsenal Sarandi,437,Rosario Central,1,1,Arsenal Sarandi,23,30,Rosario Central,20,32,-2,-3
2022,128,Liga Profesional Argentina,831669,2022-02-11T22:15:00+00:00,1st Phase - 1,438,Velez Sarsfield,463,Aldosivi,2,0,Velez Sarsfield,26,28,Aldosivi,28,16,12,2
2022,128,Liga Profesional Argentina,831670,2022-02-11T22:15:00+00:00,1st Phase - 1,439,Godoy Cruz,452,Tigre,1,1,Godoy Cruz,15,35,Tigre,7,43,-8,-8
2022,128,Liga Profesional Argentina,831671,2022-02-12T00:30:00+00:00,1st Phase - 1,449,Banfield,460,San Lorenzo,0,0,Banfield,24,30,San Lorenzo,6,43,-13,-18
2022,128,Liga Profesional Argentina,831672,2022-02-12T20:00:00+00:00,1st Phase - 1,445,Huracan,446,Lanus,1,0,Huracan,4,47,Lanus,27,21,26,23
2022,128,Liga Profesional Argentina,831673,2022-02-12T22:15:00+00:00,1st Phase - 1,441,Union Santa Fe,435,River Plate,1,0,Union Santa Fe,22,32,River Plate,3,47,-15,-19
2022,128,Liga Profesional Argentina,831674,2022-02-13T00:30:00+00:00,1st Phase - 1,450,Estudiantes L.P.,453,Independiente,2,1,Estudiantes L.P.,18,33,Independiente,14,35,-2,-4
2022,128,Liga Profesional Argentina,831675,2022-02-13T20:00:00+00:00,1st Phase - 1,436,Racing Club,434,Gimnasia L.P.,0,0,Racing Club,2,50,Gimnasia L.P.,9,41,9,7
2022,128,Liga Profesional Argentina,831676,2022-02-13T22:15:00+00:00,1st Phase - 1,1064,Platense,456,Talleres Cordoba,1,0,Platense,19,32,Talleres Cordoba,13,35,-3,-6
2022,128,Liga Profesional Argentina,831677,2022-02-14T00:30:00+00:00,1st Phase - 1,451,Boca Juniors,448,Colon Santa Fe,1,1,Boca Juniors,1,52,Colon Santa Fe,25,29,23,24
2022,128,Liga Profesional Argentina,831678,2022-02-15T20:00:00+00:00,1st Phase - 2,458,Argentinos JRS,457,Newells Old Boys,3,0,Argentinos JRS,8,42,Newells Old Boys,11,40,2,3
2022,128,Liga Profesional Argentina,831679,2022-02-15T22:15:00+00:00,1st Phase - 2,437,Rosario Central,438,Velez Sarsfield,1,0,Rosario Central,20,32,Velez Sarsfield,26,28,4,6
2022,128,Liga Profesional Argentina,831680,2022-02-15T22:15:00+00:00,1st Phase - 2,453,Independiente,459,Arsenal Sarandi,1,0,Independiente,14,35,Arsenal Sarandi,23,30,5,9
2022,128,Liga Profesional Argentina,831682,2022-02-16T00:30:00+00:00,1st Phase - 2,445,Huracan,450,Estudiantes L.P.,2,3,Huracan,4,47,Estudiantes L.P.,18,33,14,14
2022,128,Liga Profesional Argentina,831681,2022-02-16T00:30:00+00:00,1st Phase - 2,446,Lanus,2432,Barracas Central,2,0,Lanus,27,21,Barracas Central,17,34,-13,-10
2022,128,Liga Profesional Argentina,831683,2022-02-16T20:00:00+00:00,1st Phase - 2,452,Tigre,1065,Central Cordoba de Santiago,1,1,Tigre,7,43,Central Cordoba de Santiago,16,34,9,9
2022,128,Liga Profesional Argentina,831684,2022-02-16T22:15:00+00:00,1st Phase - 2,463,Aldosivi,451,Boca Juniors,1,2,Aldosivi,28,16,Boca Juniors,1,52,-36,-27
2022,128,Liga Profesional Argentina,831685,2022-02-17T00:30:00+00:00,1st Phase - 2,435,River Plate,444,Patronato,4,1,River Plate,3,47,Patronato,10,40,7,7
2022,128,Liga Profesional Argentina,831686,2022-02-17T20:00:00+00:00,1st Phase - 2,434,Gimnasia L.P.,460,San Lorenzo,1,0,Gimnasia L.P.,9,41,San Lorenzo,6,43,-2,-3
2022,128,Liga Profesional Argentina,831687,2022-02-17T20:00:00+00:00,1st Phase - 2,448,Colon Santa Fe,439,Godoy Cruz,3,1,Colon Santa Fe,25,29,Godoy Cruz,15,35,-6,-10
2022,128,Liga Profesional Argentina,831689,2022-02-17T22:15:00+00:00,1st Phase - 2,442,Defensa Y Justicia,436,Racing Club,2,2,Defensa Y Justicia,12,40,Racing Club,2,50,-10,-10
2022,128,Liga Profesional Argentina,831688,2022-02-17T22:15:00+00:00,1st Phase - 2,474,Sarmiento Junin,449,Banfield,2,2,Sarmiento Junin,21,32,Banfield,24,30,2,3
2022,128,Liga Profesional Argentina,831690,2022-02-18T00:30:00+00:00,1st Phase - 2,455,Atletico Tucuman,1064,Platense,2,2,Atletico Tucuman,5,46,Platense,19,32,14,14
2022,128,Liga Profesional Argentina,831691,2022-02-18T00:30:00+00:00,1st Phase - 2,456,Talleres Cordoba,441,Union Santa Fe,0,0,Talleres Cordoba,13,35,Union Santa Fe,22,32,3,9
2022,128,Liga Profesional Argentina,831692,2022-02-19T20:00:00+00:00,1st Phase - 3,459,Arsenal Sarandi,445,Huracan,2,1,Arsenal Sarandi,23,30,Huracan,4,47,-17,-19
2022,128,Liga Profesional Argentina,831693,2022-02-19T22:15:00+00:00,1st Phase - 3,450,Estudiantes L.P.,446,Lanus,2,1,Estudiantes L.P.,18,33,Lanus,27,21,12,9
2022,128,Liga Profesional Argentina,831694,2022-02-20T00:30:00+00:00,1st Phase - 3,438,Velez Sarsfield,453,Independiente,0,0,Velez Sarsfield,26,28,Independiente,14,35,-7,-12
2022,128,Liga Profesional Argentina,831695,2022-02-20T20:00:00+00:00,1st Phase - 3,1064,Platense,474,Sarmiento Junin,2,0,Platense,19,32,Sarmiento Junin,21,32,0,2
2022,128,Liga Profesional Argentina,831696,2022-02-20T22:15:00+00:00,1st Phase - 3,451,Boca Juniors,437,Rosario Central,2,1,Boca Juniors,1,52,Rosario Central,20,32,20,19
2022,128,Liga Profesional Argentina,831697,2022-02-21T00:30:00+00:00,1st Phase - 3,457,Newells Old Boys,435,River Plate,0,2,Newells Old Boys,11,40,River Plate,3,47,-7,-8
2022,128,Liga Profesional Argentina,831698,2022-02-21T20:00:00+00:00,1st Phase - 3,2432,Barracas Central,452,Tigre,0,2,Barracas Central,17,34,Tigre,7,43,-9,-10
2022,128,Liga Profesional Argentina,831700,2022-02-21T22:15:00+00:00,1st Phase - 3,439,Godoy Cruz,463,Aldosivi,0,2,Godoy Cruz,15,35,Aldosivi,28,16,19,13
2022,128,Liga Profesional Argentina,831699,2022-02-21T22:15:00+00:00,1st Phase - 3,449,Banfield,434,Gimnasia L.P.,4,0,Banfield,24,30,Gimnasia L.P.,9,41,-11,-15
2022,128,Liga Profesional Argentina,831701,2022-02-22T00:30:00+00:00,1st Phase - 3,460,San Lorenzo,442,Defensa Y Justicia,3,4,San Lorenzo,6,43,Defensa Y Justicia,12,40,3,6
2022,128,Liga Profesional Argentina,831703,2022-02-22T22:15:00+00:00,1st Phase - 3,441,Union Santa Fe,455,Atletico Tucuman,1,0,Union Santa Fe,22,32,Atletico Tucuman,5,46,-14,-17
2022,128,Liga Profesional Argentina,831702,2022-02-22T22:15:00+00:00,1st Phase - 3,444,Patronato,456,Talleres Cordoba,0,0,Patronato,10,40,Talleres Cordoba,13,35,5,3
2022,128,Liga Profesional Argentina,831704,2022-02-23T00:30:00+00:00,1st Phase - 3,436,Racing Club,458,Argentinos JRS,3,0,Racing Club,2,50,Argentinos JRS,8,42,8,6
2022,128,Liga Profesional Argentina,831705,2022-02-23T00:30:00+00:00,1st Phase - 3,1065,Central Cordoba de Santiago,448,Colon Santa Fe,0,2,Central Cordoba de Santiago,16,34,Colon Santa Fe,25,29,5,9
2022,128,Liga Profesional Argentina,831718,2022-02-25T00:30:00+00:00,1st Phase - 4,445,Huracan,438,Velez Sarsfield,2,0,Huracan,4,47,Velez Sarsfield,26,28,19,22
2022,128,Liga Profesional Argentina,831712,2022-02-25T22:15:00+00:00,1st Phase - 4,442,Defensa Y Justicia,434,Gimnasia L.P.,3,2,Defensa Y Justicia,12,40,Gimnasia L.P.,9,41,-1,-3
2022,128,Liga Profesional Argentina,831706,2022-02-26T00:30:00+00:00,1st Phase - 4,1064,Platense,449,Banfield,0,1,Platense,19,32,Banfield,24,30,2,5
2022,128,Liga Profesional Argentina,831716,2022-02-26T20:00:00+00:00,1st Phase - 4,437,Rosario Central,439,Godoy Cruz,1,2,Rosario Central,20,32,Godoy Cruz,15,35,-3,-5
2022,128,Liga Profesional Argentina,831714,2022-02-26T20:00:00+00:00,1st Phase - 4,448,Colon Santa Fe,2432,Barracas Central,2,1,Colon Santa Fe,25,29,Barracas Central,17,34,-5,-8
2022,128,Liga Profesional Argentina,831715,2022-02-26T22:15:00+00:00,1st Phase - 4,463,Aldosivi,1065,Central Cordoba de Santiago,0,0,Aldosivi,28,16,Central Cordoba de Santiago,16,34,-18,-12
2022,128,Liga Profesional Argentina,831717,2022-02-27T00:30:00+00:00,1st Phase - 4,453,Independiente,451,Boca Juniors,2,2,Independiente,14,35,Boca Juniors,1,52,-17,-13
2022,128,Liga Profesional Argentina,831719,2022-02-27T20:00:00+00:00,1st Phase - 4,450,Estudiantes L.P.,459,Arsenal Sarandi,3,2,Estudiantes L.P.,18,33,Arsenal Sarandi,23,30,3,5
2022,128,Liga Profesional Argentina,831707,2022-02-27T20:00:00+00:00,1st Phase - 4,474,Sarmiento Junin,441,Union Santa Fe,2,1,Sarmiento Junin,21,32,Union Santa Fe,22,32,0,1
2022,128,Liga Profesional Argentina,831710,2022-02-27T22:15:00+00:00,1st Phase - 4,435,River Plate,436,Racing Club,2,2,River Plate,3,47,Racing Club,2,50,-3,-1
2022,128,Liga Profesional Argentina,831711,2022-02-28T00:30:00+00:00,1st Phase - 4,458,Argentinos JRS,460,San Lorenzo,1,1,Argentinos JRS,8,42,San Lorenzo,6,43,-1,-2
2022,128,Liga Profesional Argentina,831709,2022-02-28T22:15:00+00:00,1st Phase - 4,456,Talleres Cordoba,457,Newells Old Boys,1,2,Talleres Cordoba,13,35,Newells Old Boys,11,40,-5,-2
2022,128,Liga Profesional Argentina,831713,2022-03-01T00:30:00+00:00,1st Phase - 4,446,Lanus,452,Tigre,0,0,Lanus,27,21,Tigre,7,43,-22,-20
2022,128,Liga Profesional Argentina,831708,2022-03-02T00:30:00+00:00,1st Phase - 4,455,Atletico Tucuman,444,Patronato,1,0,Atletico Tucuman,5,46,Patronato,10,40,6,5
2022,128,Liga Profesional Argentina,831731,2022-03-04T00:30:00+00:00,1st Phase - 5,1065,Central Cordoba de Santiago,437,Rosario Central,0,1,Central Cordoba de Santiago,16,34,Rosario Central,20,32,2,4
2022,128,Liga Profesional Argentina,831726,2022-03-04T22:15:00+00:00,1st Phase - 5,441,Union Santa Fe,1064,Platense,1,0,Union Santa Fe,22,32,Platense,19,32,0,-3
2022,128,Liga Profesional Argentina,831721,2022-03-05T00:30:00+00:00,1st Phase - 5,434,Gimnasia L.P.,458,Argentinos JRS,2,2,Gimnasia L.P.,9,41,Argentinos JRS,8,42,-1,-1
2022,128,Liga Profesional Argentina,831732,2022-03-05T00:30:00+00:00,1st Phase - 5,2432,Barracas Central,463,Aldosivi,2,1,Barracas Central,17,34,Aldosivi,28,16,18,11
2022,128,Liga Profesional Argentina,831722,2022-03-05T20:00:00+00:00,1st Phase - 5,460,San Lorenzo,435,River Plate,0,1,San Lorenzo,6,43,River Plate,3,47,-4,-3
2022,128,Liga Profesional Argentina,831725,2022-03-05T22:15:00+00:00,1st Phase - 5,444,Patronato,474,Sarmiento Junin,0,1,Patronato,10,40,Sarmiento Junin,21,32,8,11
2022,128,Liga Profesional Argentina,831723,2022-03-06T00:30:00+00:00,1st Phase - 5,436,Racing Club,456,Talleres Cordoba,1,0,Racing Club,2,50,Talleres Cordoba,13,35,15,11
2022,128,Liga Profesional Argentina,831720,2022-03-06T20:00:00+00:00,1st Phase - 5,449,Banfield,442,Defensa Y Justicia,2,3,Banfield,24,30,Defensa Y Justicia,12,40,-10,-12
2022,128,Liga Profesional Argentina,831724,2022-03-06T20:00:00+00:00,1st Phase - 5,457,Newells Old Boys,455,Atletico Tucuman,4,0,Newells Old Boys,11,40,Atletico Tucuman,5,46,-6,-6
2022,128,Liga Profesional Argentina,831729,2022-03-06T22:15:00+00:00,1st Phase - 5,451,Boca Juniors,445,Huracan,0,1,Boca Juniors,1,52,Huracan,4,47,5,3
2022,128,Liga Profesional Argentina,831728,2022-03-07T00:30:00+00:00,1st Phase - 5,438,Velez Sarsfield,450,Estudiantes L.P.,1,1,Velez Sarsfield,26,28,Estudiantes L.P.,18,33,-5,-8
2022,128,Liga Profesional Argentina,831730,2022-03-07T20:00:00+00:00,1st Phase - 5,439,Godoy Cruz,453,Independiente,3,3,Godoy Cruz,15,35,Independiente,14,35,0,-1
2022,128,Liga Profesional Argentina,831727,2022-03-07T22:15:00+00:00,1st Phase - 5,459,Arsenal Sarandi,446,Lanus,2,2,Arsenal Sarandi,23,30,Lanus,27,21,9,4
2022,128,Liga Profesional Argentina,831733,2022-03-08T00:30:00+00:00,1st Phase - 5,452,Tigre,448,Colon Santa Fe,1,0,Tigre,7,43,Colon Santa Fe,25,29,14,18
2022,128,Liga Profesional Argentina,831747,2022-03-11T22:15:00+00:00,1st Phase - 6,459,Arsenal Sarandi,438,Velez Sarsfield,0,0,Arsenal Sarandi,23,30,Velez Sarsfield,26,28,2,3
2022,128,Liga Profesional Argentina,831735,2022-03-12T00:30:00+00:00,1st Phase - 6,1064,Platense,444,Patronato,1,2,Platense,19,32,Patronato,10,40,-8,-9
2022,128,Liga Profesional Argentina,831745,2022-03-12T20:00:00+00:00,1st Phase - 6,445,Huracan,439,Godoy Cruz,1,3,Huracan,4,47,Godoy Cruz,15,35,12,11
2022,128,Liga Profesional Argentina,831742,2022-03-12T20:00:00+00:00,1st Phase - 6,463,Aldosivi,452,Tigre,1,0,Aldosivi,28,16,Tigre,7,43,-27,-21
2022,128,Liga Profesional Argentina,831743,2022-03-12T22:15:00+00:00,1st Phase - 6,437,Rosario Central,2432,Barracas Central,1,3,Rosario Central,20,32,Barracas Central,17,34,-2,-3
2022,128,Liga Profesional Argentina,831736,2022-03-12T22:15:00+00:00,1st Phase - 6,474,Sarmiento Junin,457,Newells Old Boys,2,2,Sarmiento Junin,21,32,Newells Old Boys,11,40,-8,-10
2022,128,Liga Profesional Argentina,831738,2022-03-13T00:30:00+00:00,1st Phase - 6,456,Talleres Cordoba,460,San Lorenzo,0,1,Talleres Cordoba,13,35,San Lorenzo,6,43,-8,-7
2022,128,Liga Profesional Argentina,831734,2022-03-13T20:00:00+00:00,1st Phase - 6,441,Union Santa Fe,449,Banfield,2,1,Union Santa Fe,22,32,Banfield,24,30,2,2
2022,128,Liga Profesional Argentina,831741,2022-03-13T20:00:00+00:00,1st Phase - 6,446,Lanus,448,Colon Santa Fe,1,1,Lanus,27,21,Colon Santa Fe,25,29,-8,-2
2022,128,Liga Profesional Argentina,831739,2022-03-13T22:15:00+00:00,1st Phase - 6,435,River Plate,434,Gimnasia L.P.,4,0,River Plate,3,47,Gimnasia L.P.,9,41,6,6
2022,128,Liga Profesional Argentina,831746,2022-03-14T00:30:00+00:00,1st Phase - 6,450,Estudiantes L.P.,451,Boca Juniors,0,1,Estudiantes L.P.,18,33,Boca Juniors,1,52,-19,-17
2022,128,Liga Profesional Argentina,831737,2022-03-14T22:15:00+00:00,1st Phase - 6,455,Atletico Tucuman,436,Racing Club,0,4,Atletico Tucuman,5,46,Racing Club,2,50,-4,-3
2022,128,Liga Profesional Argentina,831744,2022-03-15T00:30:00+00:00,1st Phase - 6,453,Independiente,1065,Central Cordoba de Santiago,1,1,Independiente,14,35,Central Cordoba de Santiago,16,34,1,2
2022,128,Liga Profesional Argentina,831740,2022-03-15T00:30:00+00:00,1st Phase - 6,458,Argentinos JRS,442,Defensa Y Justicia,0,1,Argentinos JRS,8,42,Defensa Y Justicia,12,40,2,4
2022,128,Liga Profesional Argentina,831758,2022-03-18T19:00:00+00:00,1st Phase - 7,463,Aldosivi,444,Patronato,3,1,Aldosivi,28,16,Patronato,10,40,-24,-18
2022,128,Liga Profesional Argentina,831760,2022-03-18T22:15:00+00:00,1st Phase - 7,452,Tigre,1064,Platense,4,0,Tigre,7,43,Platense,19,32,11,12
2022,128,Liga Profesional Argentina,831761,2022-03-19T00:30:00+00:00,1st Phase - 7,2432,Barracas Central,474,Sarmiento Junin,2,1,Barracas Central,17,34,Sarmiento Junin,21,32,2,4
2022,128,Liga Profesional Argentina,831755,2022-03-19T17:00:00+00:00,1st Phase - 7,446,Lanus,449,Banfield,0,1,Lanus,27,21,Banfield,24,30,-9,-3
2022,128,Liga Profesional Argentina,831748,2022-03-19T19:15:00+00:00,1st Phase - 7,460,San Lorenzo,445,Huracan,0,0,San Lorenzo,6,43,Huracan,4,47,-4,-2
2022,128,Liga Profesional Argentina,831759,2022-03-19T21:30:00+00:00,1st Phase - 7,448,Colon Santa Fe,441,Union Santa Fe,0,0,Colon Santa Fe,25,29,Union Santa Fe,22,32,-3,-3
2022,128,Liga Profesional Argentina,831756,2022-03-19T23:45:00+00:00,1st Phase - 7,453,Independiente,436,Racing Club,1,2,Independiente,14,35,Racing Club,2,50,-15,-12
2022,128,Liga Profesional Argentina,831757,2022-03-20T17:00:00+00:00,1st Phase - 7,437,Rosario Central,457,Newells Old Boys,0,1,Rosario Central,20,32,Newells Old Boys,11,40,-8,-9
2022,128,Liga Profesional Argentina,831749,2022-03-20T19:15:00+00:00,1st Phase - 7,434,Gimnasia L.P.,450,Estudiantes L.P.,1,1,Gimnasia L.P.,9,41,Estudiantes L.P.,18,33,8,9
2022,128,Liga Profesional Argentina,831752,2022-03-20T22:00:00+00:00,1st Phase - 7,435,River Plate,451,Boca Juniors,0,1,River Plate,3,47,Boca Juniors,1,52,-5,-2
2022,128,Liga Profesional Argentina,831750,2022-03-21T22:15:00+00:00,1st Phase - 7,442,Defensa Y Justicia,459,Arsenal Sarandi,1,1,Defensa Y Justicia,12,40,Arsenal Sarandi,23,30,10,11
2022,128,Liga Profesional Argentina,831751,2022-03-22T00:30:00+00:00,1st Phase - 7,458,Argentinos JRS,438,Velez Sarsfield,1,0,Argentinos JRS,8,42,Velez Sarsfield,26,28,14,18
2022,128,Liga Profesional Argentina,831754,2022-03-22T22:15:00+00:00,1st Phase - 7,455,Atletico Tucuman,1065,Central Cordoba de Santiago,0,1,Atletico Tucuman,5,46,Central Cordoba de Santiago,16,34,12,11
2022,128,Liga Profesional Argentina,831753,2022-03-23T00:30:00+00:00,1st Phase - 7,456,Talleres Cordoba,439,Godoy Cruz,2,1,Talleres Cordoba,13,35,Godoy Cruz,15,35,0,2
2022,128,Liga Profesional Argentina,831775,2022-04-01T00:30:00+00:00,1st Phase - 8,448,Colon Santa Fe,463,Aldosivi,1,3,Colon Santa Fe,25,29,Aldosivi,28,16,13,3
2022,128,Liga Profesional Argentina,831764,2022-04-01T19:30:00+00:00,1st Phase - 8,434,Gimnasia L.P.,456,Talleres Cordoba,2,1,Gimnasia L.P.,9,41,Talleres Cordoba,13,35,6,4
2022,128,Liga Profesional Argentina,831768,2022-04-01T22:00:00+00:00,1st Phase - 8,444,Patronato,441,Union Santa Fe,2,1,Patronato,10,40,Union Santa Fe,22,32,8,12
2022,128,Liga Profesional Argentina,831772,2022-04-01T22:00:00+00:00,1st Phase - 8,1065,Central Cordoba de Santiago,445,Huracan,2,2,Central Cordoba de Santiago,16,34,Huracan,4,47,-13,-12
2022,128,Liga Profesional Argentina,831762,2022-04-02T00:30:00+00:00,1st Phase - 8,449,Banfield,458,Argentinos JRS,0,2,Banfield,24,30,Argentinos JRS,8,42,-12,-16
2022,128,Liga Profesional Argentina,831773,2022-04-02T00:30:00+00:00,1st Phase - 8,2432,Barracas Central,453,Independiente,0,1,Barracas Central,17,34,Independiente,14,35,-1,-3
2022,128,Liga Profesional Argentina,831766,2022-04-02T17:00:00+00:00,1st Phase - 8,436,Racing Club,474,Sarmiento Junin,4,1,Racing Club,2,50,Sarmiento Junin,21,32,18,19
2022,128,Liga Profesional Argentina,831769,2022-04-02T19:30:00+00:00,1st Phase - 8,438,Velez Sarsfield,446,Lanus,3,1,Velez Sarsfield,26,28,Lanus,27,21,7,1
2022,128,Liga Profesional Argentina,831771,2022-04-02T19:30:00+00:00,1st Phase - 8,439,Godoy Cruz,450,Estudiantes L.P.,3,3,Godoy Cruz,15,35,Estudiantes L.P.,18,33,2,3
2022,128,Liga Profesional Argentina,831763,2022-04-02T22:00:00+00:00,1st Phase - 8,442,Defensa Y Justicia,435,River Plate,1,2,Defensa Y Justicia,12,40,River Plate,3,47,-7,-9
2022,128,Liga Profesional Argentina,831770,2022-04-03T00:30:00+00:00,1st Phase - 8,451,Boca Juniors,459,Arsenal Sarandi,2,2,Boca Juniors,1,52,Arsenal Sarandi,23,30,22,22
2022,128,Liga Profesional Argentina,831765,2022-04-03T19:30:00+00:00,1st Phase - 8,460,San Lorenzo,455,Atletico Tucuman,1,1,San Lorenzo,6,43,Atletico Tucuman,5,46,-3,-1
2022,128,Liga Profesional Argentina,831767,2022-04-03T22:00:00+00:00,1st Phase - 8,457,Newells Old Boys,1064,Platense,3,1,Newells Old Boys,11,40,Platense,19,32,8,8
2022,128,Liga Profesional Argentina,831774,2022-04-04T00:30:00+00:00,1st Phase - 8,452,Tigre,437,Rosario Central,2,0,Tigre,7,43,Rosario Central,20,32,11,13
2022,128,Liga Profesional Argentina,831780,2022-04-08T22:00:00+00:00,1st Phase - 9,455,Atletico Tucuman,434,Gimnasia L.P.,1,2,Atletico Tucuman,5,46,Gimnasia L.P.,9,41,5,4
2022,128,Liga Profesional Argentina,831788,2022-04-08T22:00:00+00:00,1st Phase - 9,459,Arsenal Sarandi,439,Godoy Cruz,3,3,Arsenal Sarandi,23,30,Godoy Cruz,15,35,-5,-8
2022,128,Liga Profesional Argentina,831784,2022-04-09T00:30:00+00:00,1st Phase - 9,437,Rosario Central,448,Colon Santa Fe,2,2,Rosario Central,20,32,Colon Santa Fe,25,29,3,5
2022,128,Liga Profesional Argentina,831779,2022-04-09T00:30:00+00:00,1st Phase - 9,474,Sarmiento Junin,460,San Lorenzo,2,1,Sarmiento Junin,21,32,San Lorenzo,6,43,-11,-15
2022,128,Liga Profesional Argentina,831777,2022-04-09T17:00:00+00:00,1st Phase - 9,441,Union Santa Fe,457,Newells Old Boys,1,0,Union Santa Fe,22,32,Newells Old Boys,11,40,-8,-11
2022,128,Liga Profesional Argentina,831781,2022-04-09T19:30:00+00:00,1st Phase - 9,456,Talleres Cordoba,442,Defensa Y Justicia,1,5,Talleres Cordoba,13,35,Defensa Y Justicia,12,40,-5,-1
2022,128,Liga Profesional Argentina,831785,2022-04-09T22:00:00+00:00,1st Phase - 9,453,Independiente,452,Tigre,1,1,Independiente,14,35,Tigre,7,43,-8,-7
2022,128,Liga Profesional Argentina,831789,2022-04-10T00:30:00+00:00,1st Phase - 9,438,Velez Sarsfield,451,Boca Juniors,0,0,Velez Sarsfield,26,28,Boca Juniors,1,52,-24,-25
2022,128,Liga Profesional Argentina,831776,2022-04-10T17:00:00+00:00,1st Phase - 9,444,Patronato,449,Banfield,0,1,Patronato,10,40,Banfield,24,30,10,14
2022,128,Liga Profesional Argentina,831787,2022-04-10T17:00:00+00:00,1st Phase - 9,450,Estudiantes L.P.,1065,Central Cordoba de Santiago,5,0,Estudiantes L.P.,18,33,Central Cordoba de Santiago,16,34,-1,-2
2022,128,Liga Profesional Argentina,831778,2022-04-10T19:30:00+00:00,1st Phase - 9,1064,Platense,436,Racing Club,0,1,Platense,19,32,Racing Club,2,50,-18,-17
2022,128,Liga Profesional Argentina,831782,2022-04-10T22:00:00+00:00,1st Phase - 9,435,River Plate,458,Argentinos JRS,4,2,River Plate,3,47,Argentinos JRS,8,42,5,5
2022,128,Liga Profesional Argentina,831786,2022-04-11T22:00:00+00:00,1st Phase - 9,445,Huracan,2432,Barracas Central,1,2,Huracan,4,47,Barracas Central,17,34,13,13
2022,128,Liga Profesional Argentina,831783,2022-04-12T00:30:00+00:00,1st Phase - 9,446,Lanus,463,Aldosivi,1,2,Lanus,27,21,Aldosivi,28,16,5,1
2022,128,Liga Profesional Argentina,831793,2022-04-15T00:30:00+00:00,1st Phase - 10,434,Gimnasia L.P.,474,Sarmiento Junin,1,3,Gimnasia L.P.,9,41,Sarmiento Junin,21,32,9,12
2022,128,Liga Profesional Argentina,831801,2022-04-15T19:30:00+00:00,1st Phase - 10,452,Tigre,445,Huracan,2,1,Tigre,7,43,Huracan,4,47,-4,-3
2022,128,Liga Profesional Argentina,831803,2022-04-15T22:00:00+00:00,1st Phase - 10,463,Aldosivi,437,Rosario Central,1,0,Aldosivi,28,16,Rosario Central,20,32,-16,-8
2022,128,Liga Profesional Argentina,831799,2022-04-15T22:00:00+00:00,1st Phase - 10,1065,Central Cordoba de Santiago,459,Arsenal Sarandi,3,3,Central Cordoba de Santiago,16,34,Arsenal Sarandi,23,30,4,7
2022,128,Liga Profesional Argentina,831796,2022-04-16T00:30:00+00:00,1st Phase - 10,457,Newells Old Boys,444,Patronato,1,0,Newells Old Boys,11,40,Patronato,10,40,0,-1
2022,128,Liga Profesional Argentina,831794,2022-04-16T17:00:00+00:00,1st Phase - 10,460,San Lorenzo,1064,Platense,2,2,San Lorenzo,6,43,Platense,19,32,11,13
2022,128,Liga Profesional Argentina,831802,2022-04-16T19:30:00+00:00,1st Phase - 10,448,Colon Santa Fe,453,Independiente,2,2,Colon Santa Fe,25,29,Independiente,14,35,-6,-11
2022,128,Liga Profesional Argentina,831800,2022-04-16T22:00:00+00:00,1st Phase - 10,2432,Barracas Central,450,Estudiantes L.P.,1,6,Barracas Central,17,34,Estudiantes L.P.,18,33,1,1
2022,128,Liga Profesional Argentina,831795,2022-04-17T00:30:00+00:00,1st Phase - 10,436,Racing Club,441,Union Santa Fe,1,0,Racing Club,2,50,Union Santa Fe,22,32,18,20
2022,128,Liga Profesional Argentina,831798,2022-04-17T17:00:00+00:00,1st Phase - 10,439,Godoy Cruz,438,Velez Sarsfield,0,0,Godoy Cruz,15,35,Velez Sarsfield,26,28,7,11
2022,128,Liga Profesional Argentina,831792,2022-04-17T17:00:00+00:00,1st Phase - 10,442,Defensa Y Justicia,455,Atletico Tucuman,1,1,Defensa Y Justicia,12,40,Atletico Tucuman,5,46,-6,-7
2022,128,Liga Profesional Argentina,831791,2022-04-17T19:30:00+00:00,1st Phase - 10,458,Argentinos JRS,456,Talleres Cordoba,2,1,Argentinos JRS,8,42,Talleres Cordoba,13,35,7,5
2022,128,Liga Profesional Argentina,831797,2022-04-17T22:00:00+00:00,1st Phase - 10,451,Boca Juniors,446,Lanus,1,1,Boca Juniors,1,52,Lanus,27,21,31,26
2022,128,Liga Profesional Argentina,831790,2022-04-18T00:30:00+00:00,1st Phase - 10,449,Banfield,435,River Plate,1,2,Banfield,24,30,River Plate,3,47,-17,-21
2022,128,Liga Profesional Argentina,831815,2022-04-19T17:00:00+00:00,1st Phase - 11,459,Arsenal Sarandi,2432,Barracas Central,0,1,Arsenal Sarandi,23,30,Barracas Central,17,34,-4,-6
2022,128,Liga Profesional Argentina,831806,2022-04-19T19:30:00+00:00,1st Phase - 11,441,Union Santa Fe,460,San Lorenzo,1,2,Union Santa Fe,22,32,San Lorenzo,6,43,-11,-16
2022,128,Liga Profesional Argentina,831813,2022-04-19T22:00:00+00:00,1st Phase - 11,445,Huracan,448,Colon Santa Fe,1,1,Huracan,4,47,Colon Santa Fe,25,29,18,21
2022,128,Liga Profesional Argentina,831814,2022-04-19T22:00:00+00:00,1st Phase - 11,450,Estudiantes L.P.,452,Tigre,2,1,Estudiantes L.P.,18,33,Tigre,7,43,-10,-11
2022,128,Liga Profesional Argentina,831812,2022-04-20T00:30:00+00:00,1st Phase - 11,453,Independiente,463,Aldosivi,1,1,Independiente,14,35,Aldosivi,28,16,19,14
2022,128,Liga Profesional Argentina,831807,2022-04-20T00:30:00+00:00,1st Phase - 11,1064,Platense,434,Gimnasia L.P.,0,3,Platense,19,32,Gimnasia L.P.,9,41,-9,-10
2022,128,Liga Profesional Argentina,831804,2022-04-20T17:00:00+00:00,1st Phase - 11,457,Newells Old Boys,449,Banfield,1,0,Newells Old Boys,11,40,Banfield,24,30,10,13
2022,128,Liga Profesional Argentina,831816,2022-04-20T19:30:00+00:00,1st Phase - 11,438,Velez Sarsfield,1065,Central Cordoba de Santiago,1,2,Velez Sarsfield,26,28,Central Cordoba de Santiago,16,34,-6,-10
2022,128,Liga Profesional Argentina,831805,2022-04-20T19:30:00+00:00,1st Phase - 11,444,Patronato,436,Racing Club,2,3,Patronato,10,40,Racing Club,2,50,-10,-8
2022,128,Liga Profesional Argentina,831811,2022-04-20T22:00:00+00:00,1st Phase - 11,446,Lanus,437,Rosario Central,3,1,Lanus,27,21,Rosario Central,20,32,-11,-7
2022,128,Liga Profesional Argentina,831810,2022-04-20T22:00:00+00:00,1st Phase - 11,456,Talleres Cordoba,435,River Plate,1,0,Talleres Cordoba,13,35,River Plate,3,47,-12,-10
2022,128,Liga Profesional Argentina,831817,2022-04-21T00:30:00+00:00,1st Phase - 11,451,Boca Juniors,439,Godoy Cruz,1,1,Boca Juniors,1,52,Godoy Cruz,15,35,17,14
2022,128,Liga Profesional Argentina,831808,2022-04-21T19:00:00+00:00,1st Phase - 11,474,Sarmiento Junin,442,Defensa Y Justicia,2,1,Sarmiento Junin,21,32,Defensa Y Justicia,12,40,-8,-9
2022,128,Liga Profesional Argentina,831809,2022-04-21T21:30:00+00:00,1st Phase - 11,455,Atletico Tucuman,458,Argentinos JRS,2,4,Atletico Tucuman,5,46,Argentinos JRS,8,42,4,3
2022,128,Liga Profesional Argentina,831829,2022-04-22T23:30:00+00:00,1st Phase - 12,448,Colon Santa Fe,450,Estudiantes L.P.,2,2,Colon Santa Fe,25,29,Estudiantes L.P.,18,33,-4,-7
2022,128,Liga Profesional Argentina,831822,2022-04-23T17:00:00+00:00,1st Phase - 12,434,Gimnasia L.P.,441,Union Santa Fe,1,0,Gimnasia L.P.,9,41,Union Santa Fe,22,32,9,13
2022,128,Liga Profesional Argentina,831823,2022-04-23T17:00:00+00:00,1st Phase - 12,460,San Lorenzo,444,Patronato,1,2,San Lorenzo,6,43,Patronato,10,40,3,4
2022,128,Liga Profesional Argentina,831831,2022-04-23T19:30:00+00:00,1st Phase - 12,437,Rosario Central,453,Independiente,3,0,Rosario Central,20,32,Independiente,14,35,-3,-6
2022,128,Liga Profesional Argentina,831826,2022-04-23T22:00:00+00:00,1st Phase - 12,1065,Central Cordoba de Santiago,451,Boca Juniors,1,2,Central Cordoba de Santiago,16,34,Boca Juniors,1,52,-18,-15
2022,128,Liga Profesional Argentina,831818,2022-04-24T00:30:00+00:00,1st Phase - 12,449,Banfield,456,Talleres Cordoba,3,1,Banfield,24,30,Talleres Cordoba,13,35,-5,-11
2022,128,Liga Profesional Argentina,831827,2022-04-24T00:30:00+00:00,1st Phase - 12,2432,Barracas Central,438,Velez Sarsfield,1,1,Barracas Central,17,34,Velez Sarsfield,26,28,6,9
2022,128,Liga Profesional Argentina,831824,2022-04-24T19:30:00+00:00,1st Phase - 12,436,Racing Club,457,Newells Old Boys,0,0,Racing Club,2,50,Newells Old Boys,11,40,10,9
2022,128,Liga Profesional Argentina,831819,2022-04-24T22:00:00+00:00,1st Phase - 12,435,River Plate,455,Atletico Tucuman,1,1,River Plate,3,47,Atletico Tucuman,5,46,1,2
2022,128,Liga Profesional Argentina,831825,2022-04-25T00:30:00+00:00,1st Phase - 12,439,Godoy Cruz,446,Lanus,1,1,Godoy Cruz,15,35,Lanus,27,21,14,12
2022,128,Liga Profesional Argentina,831821,2022-04-25T00:30:00+00:00,1st Phase - 12,442,Defensa Y Justicia,1064,Platense,1,1,Defensa Y Justicia,12,40,Platense,19,32,8,7
2022,128,Liga Profesional Argentina,831828,2022-04-25T18:30:00+00:00,1st Phase - 12,452,Tigre,459,Arsenal Sarandi,0,0,Tigre,7,43,Arsenal Sarandi,23,30,13,16
2022,128,Liga Profesional Argentina,831820,2022-04-26T00:30:00+00:00,1st Phase - 12,458,Argentinos JRS,474,Sarmiento Junin,0,0,Argentinos JRS,8,42,Sarmiento Junin,21,32,10,13
2022,128,Liga Profesional Argentina,831830,2022-04-26T00:30:00+00:00,1st Phase - 12,463,Aldosivi,445,Huracan,0,2,Aldosivi,28,16,Huracan,4,47,-31,-24
2022,128,Liga Profesional Argentina,831833,2022-04-27T23:30:00+00:00,1st Phase - 13,457,Newells Old Boys,460,San Lorenzo,1,2,Newells Old Boys,11,40,San Lorenzo,6,43,-3,-5
2022,128,Liga Profesional Argentina,831841,2022-04-29T22:00:00+00:00,1st Phase - 13,450,Estudiantes L.P.,463,Aldosivi,2,1,Estudiantes L.P.,18,33,Aldosivi,28,16,17,10
2022,128,Liga Profesional Argentina,831834,2022-04-30T00:30:00+00:00,1st Phase - 13,444,Patronato,434,Gimnasia L.P.,0,6,Patronato,10,40,Gimnasia L.P.,9,41,-1,-1
2022,128,Liga Profesional Argentina,831838,2022-04-30T15:00:00+00:00,1st Phase - 13,455,Atletico Tucuman,456,Talleres Cordoba,3,0,Atletico Tucuman,5,46,Talleres Cordoba,13,35,11,8
2022,128,Liga Profesional Argentina,831832,2022-04-30T19:00:00+00:00,1st Phase - 13,436,Racing Club,449,Banfield,1,1,Racing Club,2,50,Banfield,24,30,20,22
2022,128,Liga Profesional Argentina,831843,2022-04-30T19:00:00+00:00,1st Phase - 13,438,Velez Sarsfield,452,Tigre,3,2,Velez Sarsfield,26,28,Tigre,7,43,-15,-19
2022,128,Liga Profesional Argentina,831844,2022-04-30T22:00:00+00:00,1st Phase - 13,451,Boca Juniors,2432,Barracas Central,2,0,Boca Juniors,1,52,Barracas Central,17,34,18,16
2022,128,Liga Profesional Argentina,831842,2022-04-30T22:00:00+00:00,1st Phase - 13,459,Arsenal Sarandi,448,Colon Santa Fe,2,0,Arsenal Sarandi,23,30,Colon Santa Fe,25,29,1,2
2022,128,Liga Profesional Argentina,831839,2022-05-01T00:30:00+00:00,1st Phase - 13,446,Lanus,453,Independiente,1,0,Lanus,27,21,Independiente,14,35,-14,-13
2022,128,Liga Profesional Argentina,831837,2022-05-01T00:30:00+00:00,1st Phase - 13,474,Sarmiento Junin,435,River Plate,0,7,Sarmiento Junin,21,32,River Plate,3,47,-15,-18
2022,128,Liga Profesional Argentina,831845,2022-05-02T22:00:00+00:00,1st Phase - 13,439,Godoy Cruz,1065,Central Cordoba de Santiago,1,0,Godoy Cruz,15,35,Central Cordoba de Santiago,16,34,1,1
2022,128,Liga Profesional Argentina,831835,2022-05-02T22:00:00+00:00,1st Phase - 13,441,Union Santa Fe,442,Defensa Y Justicia,1,2,Union Santa Fe,22,32,Defensa Y Justicia,12,40,-8,-10
2022,128,Liga Profesional Argentina,831840,2022-05-03T00:30:00+00:00,1st Phase - 13,445,Huracan,437,Rosario Central,2,1,Huracan,4,47,Rosario Central,20,32,15,16
2022,128,Liga Profesional Argentina,831836,2022-05-03T00:30:00+00:00,1st Phase - 13,1064,Platense,458,Argentinos JRS,1,1,Platense,19,32,Argentinos JRS,8,42,-10,-11
2022,128,Liga Profesional Argentina,831852,2022-05-06T21:30:00+00:00,1st Phase - 14,460,San Lorenzo,436,Racing Club,1,1,San Lorenzo,6,43,Racing Club,2,50,-7,-4
2022,128,Liga Profesional Argentina,831854,2022-05-07T00:30:00+00:00,1st Phase - 14,2432,Barracas Central,439,Godoy Cruz,3,1,Barracas Central,17,34,Godoy Cruz,15,35,-1,-2
2022,128,Liga Profesional Argentina,831855,2022-05-07T19:30:00+00:00,1st Phase - 14,452,Tigre,451,Boca Juniors,0,2,Tigre,7,43,Boca Juniors,1,52,-9,-6
2022,128,Liga Profesional Argentina,831859,2022-05-07T19:30:00+00:00,1st Phase - 14,453,Independiente,445,Huracan,3,0,Independiente,14,35,Huracan,4,47,-12,-10
2022,128,Liga Profesional Argentina,831857,2022-05-07T19:30:00+00:00,1st Phase - 14,463,Aldosivi,459,Arsenal Sarandi,1,2,Aldosivi,28,16,Arsenal Sarandi,23,30,-14,-5
2022,128,Liga Profesional Argentina,831858,2022-05-07T22:00:00+00:00,1st Phase - 14,437,Rosario Central,450,Estudiantes L.P.,3,1,Rosario Central,20,32,Estudiantes L.P.,18,33,-1,-2
2022,128,Liga Profesional Argentina,831851,2022-05-08T19:00:00+00:00,1st Phase - 14,434,Gimnasia L.P.,457,Newells Old Boys,3,1,Gimnasia L.P.,9,41,Newells Old Boys,11,40,1,2
2022,128,Liga Profesional Argentina,831850,2022-05-08T19:00:00+00:00,1st Phase - 14,442,Defensa Y Justicia,444,Patronato,1,0,Defensa Y Justicia,12,40,Patronato,10,40,0,-2
2022,128,Liga Profesional Argentina,831847,2022-05-08T19:00:00+00:00,1st Phase - 14,456,Talleres Cordoba,474,Sarmiento Junin,1,0,Talleres Cordoba,13,35,Sarmiento Junin,21,32,3,8
2022,128,Liga Profesional Argentina,831849,2022-05-08T19:00:00+00:00,1st Phase - 14,458,Argentinos JRS,441,Union Santa Fe,2,1,Argentinos JRS,8,42,Union Santa Fe,22,32,10,14
2022,128,Liga Profesional Argentina,831848,2022-05-09T00:00:00+00:00,1st Phase - 14,435,River Plate,1064,Platense,2,1,River Plate,3,47,Platense,19,32,15,16
2022,128,Liga Profesional Argentina,831856,2022-05-09T22:00:00+00:00,1st Phase - 14,448,Colon Santa Fe,438,Velez Sarsfield,1,2,Colon Santa Fe,25,29,Velez Sarsfield,26,28,1,1
2022,128,Liga Profesional Argentina,831853,2022-05-09T22:00:00+00:00,1st Phase - 14,1065,Central Cordoba de Santiago,446,Lanus,3,3,Central Cordoba de Santiago,16,34,Lanus,27,21,13,11
2022,128,Liga Profesional Argentina,831846,2022-05-10T00:30:00+00:00,1st Phase - 14,449,Banfield,455,Atletico Tucuman,1,1,Banfield,24,30,Atletico Tucuman,5,46,-16,-19
2022,128,Liga Profesional Argentina,861539,2022-05-10T22:15:00+00:00,1st Phase - Quarter-finals,436,Racing Club,463,Aldosivi,5,0,Racing Club,2,50,Aldosivi,28,16,34,26
2022,128,Liga Profesional Argentina,861540,2022-05-11T00:30:00+00:00,1st Phase - Quarter-finals,451,Boca Juniors,442,Defensa Y Justicia,2,0,Boca Juniors,1,52,Defensa Y Justicia,12,40,12,11
2022,128,Liga Profesional Argentina,861541,2022-05-11T22:15:00+00:00,1st Phase - Quarter-finals,450,Estudiantes L.P.,458,Argentinos JRS,1,1,Estudiantes L.P.,18,33,Argentinos JRS,8,42,-9,-10
2022,128,Liga Profesional Argentina,861542,2022-05-12T00:30:00+00:00,1st Phase - Quarter-finals,435,River Plate,452,Tigre,1,2,River Plate,3,47,Tigre,7,43,4,4
2022,128,Liga Profesional Argentina,861839,2022-05-14T20:00:00+00:00,1st Phase - Semi-finals,451,Boca Juniors,436,Racing Club,0,0,Boca Juniors,1,52,Racing Club,2,50,2,1
2022,128,Liga Profesional Argentina,861840,2022-05-15T19:00:00+00:00,1st Phase - Semi-finals,452,Tigre,458,Argentinos JRS,1,1,Tigre,7,43,Argentinos JRS,8,42,1,1
2022,128,Liga Profesional Argentina,862248,2022-05-22T19:00:00+00:00,1st Phase - Final,451,Boca Juniors,452,Tigre,3,0,Boca Juniors,1,52,Tigre,7,43,9,6
2022,128,Liga Profesional Argentina,863169,2022-06-03T23:00:00+00:00,2nd Phase - 1,2432,Barracas Central,1065,Central Cordoba de Santiago,1,1,Barracas Central,17,34,Central Cordoba de Santiago,16,34,0,-1
2022,128,Liga Profesional Argentina,863171,2022-06-04T15:00:00+00:00,2nd Phase - 1,455,Atletico Tucuman,448,Colon Santa Fe,1,1,Atletico Tucuman,5,46,Colon Santa Fe,25,29,17,20
2022,128,Liga Profesional Argentina,863170,2022-06-04T17:00:00+00:00,2nd Phase - 1,460,San Lorenzo,453,Independiente,1,1,San Lorenzo,6,43,Independiente,14,35,8,8
2022,128,Liga Profesional Argentina,863172,2022-06-04T19:30:00+00:00,2nd Phase - 1,449,Banfield,457,Newells Old Boys,1,2,Banfield,24,30,Newells Old Boys,11,40,-10,-13
2022,128,Liga Profesional Argentina,863173,2022-06-04T22:00:00+00:00,2nd Phase - 1,444,Patronato,438,Velez Sarsfield,1,1,Patronato,10,40,Velez Sarsfield,26,28,12,16
2022,128,Liga Profesional Argentina,863174,2022-06-04T22:00:00+00:00,2nd Phase - 1,1064,Platense,439,Godoy Cruz,2,1,Platense,19,32,Godoy Cruz,15,35,-3,-4
2022,128,Liga Profesional Argentina,863175,2022-06-05T00:30:00+00:00,2nd Phase - 1,436,Racing Club,445,Huracan,2,0,Racing Club,2,50,Huracan,4,47,3,2
2022,128,Liga Profesional Argentina,863176,2022-06-05T16:00:00+00:00,2nd Phase - 1,441,Union Santa Fe,452,Tigre,1,2,Union Santa Fe,22,32,Tigre,7,43,-11,-15
2022,128,Liga Profesional Argentina,863177,2022-06-05T16:00:00+00:00,2nd Phase - 1,456,Talleres Cordoba,474,Sarmiento Junin,2,0,Talleres Cordoba,13,35,Sarmiento Junin,21,32,3,8
2022,128,Liga Profesional Argentina,863178,2022-06-05T20:00:00+00:00,2nd Phase - 1,450,Estudiantes L.P.,434,Gimnasia L.P.,1,1,Estudiantes L.P.,18,33,Gimnasia L.P.,9,41,-8,-9
2022,128,Liga Profesional Argentina,863179,2022-06-05T22:30:00+00:00,2nd Phase - 1,451,Boca Juniors,459,Arsenal Sarandi,2,1,Boca Juniors,1,52,Arsenal Sarandi,23,30,22,22
2022,128,Liga Profesional Argentina,863180,2022-06-06T00:30:00+00:00,2nd Phase - 1,442,Defensa Y Justicia,435,River Plate,0,0,Defensa Y Justicia,12,40,River Plate,3,47,-7,-9
2022,128,Liga Profesional Argentina,863181,2022-06-06T22:00:00+00:00,2nd Phase - 1,437,Rosario Central,446,Lanus,0,0,Rosario Central,20,32,Lanus,27,21,11,7
2022,128,Liga Profesional Argentina,863182,2022-06-07T00:30:00+00:00,2nd Phase - 1,458,Argentinos JRS,463,Aldosivi,2,1,Argentinos JRS,8,42,Aldosivi,28,16,26,20
2022,128,Liga Profesional Argentina,863193,2022-06-09T23:00:00+00:00,2nd Phase - 2,457,Newells Old Boys,460,San Lorenzo,0,0,Newells Old Boys,11,40,San Lorenzo,6,43,-3,-5
2022,128,Liga Profesional Argentina,863189,2022-06-10T19:30:00+00:00,2nd Phase - 2,434,Gimnasia L.P.,444,Patronato,2,0,Gimnasia L.P.,9,41,Patronato,10,40,1,1
2022,128,Liga Profesional Argentina,863185,2022-06-10T22:00:00+00:00,2nd Phase - 2,446,Lanus,442,Defensa Y Justicia,1,1,Lanus,27,21,Defensa Y Justicia,12,40,-19,-15
2022,128,Liga Profesional Argentina,863190,2022-06-10T22:00:00+00:00,2nd Phase - 2,463,Aldosivi,450,Estudiantes L.P.,0,1,Aldosivi,28,16,Estudiantes L.P.,18,33,-17,-10
2022,128,Liga Profesional Argentina,863186,2022-06-11T00:30:00+00:00,2nd Phase - 2,445,Huracan,437,Rosario Central,2,0,Huracan,4,47,Rosario Central,20,32,15,16
2022,128,Liga Profesional Argentina,863192,2022-06-11T00:30:00+00:00,2nd Phase - 2,453,Independiente,456,Talleres Cordoba,1,0,Independiente,14,35,Talleres Cordoba,13,35,0,-1
2022,128,Liga Profesional Argentina,863196,2022-06-11T18:30:00+00:00,2nd Phase - 2,452,Tigre,2432,Barracas Central,1,1,Tigre,7,43,Barracas Central,17,34,9,10
2022,128,Liga Profesional Argentina,863194,2022-06-11T18:30:00+00:00,2nd Phase - 2,459,Arsenal Sarandi,449,Banfield,0,0,Arsenal Sarandi,23,30,Banfield,24,30,0,1
2022,128,Liga Profesional Argentina,863191,2022-06-11T21:00:00+00:00,2nd Phase - 2,474,Sarmiento Junin,458,Argentinos JRS,1,0,Sarmiento Junin,21,32,Argentinos JRS,8,42,-10,-13
2022,128,Liga Profesional Argentina,863184,2022-06-11T23:30:00+00:00,2nd Phase - 2,435,River Plate,455,Atletico Tucuman,0,0,River Plate,3,47,Atletico Tucuman,5,46,1,2
2022,128,Liga Profesional Argentina,863183,2022-06-12T16:00:00+00:00,2nd Phase - 2,448,Colon Santa Fe,441,Union Santa Fe,2,2,Colon Santa Fe,25,29,Union Santa Fe,22,32,-3,-3
2022,128,Liga Profesional Argentina,863187,2022-06-12T18:30:00+00:00,2nd Phase - 2,439,Godoy Cruz,436,Racing Club,2,0,Godoy Cruz,15,35,Racing Club,2,50,-15,-13
2022,128,Liga Profesional Argentina,863188,2022-06-12T21:00:00+00:00,2nd Phase - 2,438,Velez Sarsfield,1064,Platense,0,1,Velez Sarsfield,26,28,Platense,19,32,-4,-7
2022,128,Liga Profesional Argentina,863195,2022-06-12T23:30:00+00:00,2nd Phase - 2,1065,Central Cordoba de Santiago,451,Boca Juniors,1,0,Central Cordoba de Santiago,16,34,Boca Juniors,1,52,-18,-15
2022,128,Liga Profesional Argentina,863200,2022-06-14T18:00:00+00:00,2nd Phase - 3,460,San Lorenzo,459,Arsenal Sarandi,3,3,San Lorenzo,6,43,Arsenal Sarandi,23,30,13,17
2022,128,Liga Profesional Argentina,863204,2022-06-14T22:00:00+00:00,2nd Phase - 3,444,Patronato,463,Aldosivi,1,0,Patronato,10,40,Aldosivi,28,16,24,18
2022,128,Liga Profesional Argentina,863201,2022-06-14T22:00:00+00:00,2nd Phase - 3,456,Talleres Cordoba,457,Newells Old Boys,0,1,Talleres Cordoba,13,35,Newells Old Boys,11,40,-5,-2
2022,128,Liga Profesional Argentina,863208,2022-06-15T00:30:00+00:00,2nd Phase - 3,442,Defensa Y Justicia,445,Huracan,1,1,Defensa Y Justicia,12,40,Huracan,4,47,-7,-8
2022,128,Liga Profesional Argentina,863203,2022-06-15T00:30:00+00:00,2nd Phase - 3,450,Estudiantes L.P.,474,Sarmiento Junin,2,1,Estudiantes L.P.,18,33,Sarmiento Junin,21,32,1,3
2022,128,Liga Profesional Argentina,863197,2022-06-15T17:00:00+00:00,2nd Phase - 3,2432,Barracas Central,441,Union Santa Fe,1,2,Barracas Central,17,34,Union Santa Fe,22,32,2,5
2022,128,Liga Profesional Argentina,863199,2022-06-15T19:30:00+00:00,2nd Phase - 3,449,Banfield,1065,Central Cordoba de Santiago,2,1,Banfield,24,30,Central Cordoba de Santiago,16,34,-4,-8
2022,128,Liga Profesional Argentina,863209,2022-06-15T19:30:00+00:00,2nd Phase - 3,455,Atletico Tucuman,446,Lanus,2,1,Atletico Tucuman,5,46,Lanus,27,21,25,22
2022,128,Liga Profesional Argentina,863210,2022-06-15T22:00:00+00:00,2nd Phase - 3,448,Colon Santa Fe,435,River Plate,1,0,Colon Santa Fe,25,29,River Plate,3,47,-18,-22
2022,128,Liga Profesional Argentina,863198,2022-06-16T00:30:00+00:00,2nd Phase - 3,451,Boca Juniors,452,Tigre,5,3,Boca Juniors,1,52,Tigre,7,43,9,6
2022,128,Liga Profesional Argentina,863207,2022-06-16T22:00:00+00:00,2nd Phase - 3,437,Rosario Central,439,Godoy Cruz,1,0,Rosario Central,20,32,Godoy Cruz,15,35,-3,-5
2022,128,Liga Profesional Argentina,863202,2022-06-16T22:00:00+00:00,2nd Phase - 3,458,Argentinos JRS,453,Independiente,2,1,Argentinos JRS,8,42,Independiente,14,35,7,6
2022,128,Liga Profesional Argentina,863206,2022-06-17T00:30:00+00:00,2nd Phase - 3,436,Racing Club,438,Velez Sarsfield,2,0,Racing Club,2,50,Velez Sarsfield,26,28,22,24
2022,128,Liga Profesional Argentina,863205,2022-06-17T00:30:00+00:00,2nd Phase - 3,1064,Platense,434,Gimnasia L.P.,1,1,Platense,19,32,Gimnasia L.P.,9,41,-9,-10
2022,128,Liga Profesional Argentina,863221,2022-06-18T21:00:00+00:00,2nd Phase - 4,459,Arsenal Sarandi,456,Talleres Cordoba,1,1,Arsenal Sarandi,23,30,Talleres Cordoba,13,35,-5,-10
2022,128,Liga Profesional Argentina,863218,2022-06-18T23:30:00+00:00,2nd Phase - 4,474,Sarmiento Junin,444,Patronato,3,1,Sarmiento Junin,21,32,Patronato,10,40,-8,-11
2022,128,Liga Profesional Argentina,863223,2022-06-19T16:00:00+00:00,2nd Phase - 4,452,Tigre,449,Banfield,0,1,Tigre,7,43,Banfield,24,30,13,17
2022,128,Liga Profesional Argentina,863213,2022-06-19T18:30:00+00:00,2nd Phase - 4,445,Huracan,455,Atletico Tucuman,0,0,Huracan,4,47,Atletico Tucuman,5,46,1,1
2022,128,Liga Profesional Argentina,863212,2022-06-19T18:30:00+00:00,2nd Phase - 4,446,Lanus,448,Colon Santa Fe,1,0,Lanus,27,21,Colon Santa Fe,25,29,-8,-2
2022,128,Liga Profesional Argentina,863211,2022-06-19T21:00:00+00:00,2nd Phase - 4,441,Union Santa Fe,435,River Plate,1,5,Union Santa Fe,22,32,River Plate,3,47,-15,-19
2022,128,Liga Profesional Argentina,863224,2022-06-20T00:30:00+00:00,2nd Phase - 4,2432,Barracas Central,451,Boca Juniors,1,3,Barracas Central,17,34,Boca Juniors,1,52,-18,-16
2022,128,Liga Profesional Argentina,863214,2022-06-20T19:30:00+00:00,2nd Phase - 4,439,Godoy Cruz,442,Defensa Y Justicia,2,1,Godoy Cruz,15,35,Defensa Y Justicia,12,40,-5,-3
2022,128,Liga Profesional Argentina,863216,2022-06-20T22:00:00+00:00,2nd Phase - 4,434,Gimnasia L.P.,436,Racing Club,3,1,Gimnasia L.P.,9,41,Racing Club,2,50,-9,-7
2022,128,Liga Profesional Argentina,863215,2022-06-20T22:00:00+00:00,2nd Phase - 4,438,Velez Sarsfield,437,Rosario Central,2,0,Velez Sarsfield,26,28,Rosario Central,20,32,-4,-6
2022,128,Liga Profesional Argentina,863219,2022-06-21T00:30:00+00:00,2nd Phase - 4,453,Independiente,450,Estudiantes L.P.,2,1,Independiente,14,35,Estudiantes L.P.,18,33,2,4
2022,128,Liga Profesional Argentina,863220,2022-06-21T00:30:00+00:00,2nd Phase - 4,457,Newells Old Boys,458,Argentinos JRS,1,0,Newells Old Boys,11,40,Argentinos JRS,8,42,-2,-3
2022,128,Liga Profesional Argentina,863217,2022-06-21T22:00:00+00:00,2nd Phase - 4,463,Aldosivi,1064,Platense,0,0,Aldosivi,28,16,Platense,19,32,-16,-9
2022,128,Liga Profesional Argentina,863222,2022-06-22T00:30:00+00:00,2nd Phase - 4,1065,Central Cordoba de Santiago,460,San Lorenzo,0,2,Central Cordoba de Santiago,16,34,San Lorenzo,6,43,-9,-10
2022,128,Liga Profesional Argentina,863234,2022-06-24T22:00:00+00:00,2nd Phase - 5,437,Rosario Central,434,Gimnasia L.P.,0,1,Rosario Central,20,32,Gimnasia L.P.,9,41,-9,-11
2022,128,Liga Profesional Argentina,863226,2022-06-24T22:00:00+00:00,2nd Phase - 5,449,Banfield,2432,Barracas Central,1,1,Banfield,24,30,Barracas Central,17,34,-4,-7
2022,128,Liga Profesional Argentina,863225,2022-06-25T00:30:00+00:00,2nd Phase - 5,451,Boca Juniors,441,Union Santa Fe,1,2,Boca Juniors,1,52,Union Santa Fe,22,32,20,21
2022,128,Liga Profesional Argentina,863235,2022-06-25T18:30:00+00:00,2nd Phase - 5,442,Defensa Y Justicia,438,Velez Sarsfield,1,1,Defensa Y Justicia,12,40,Velez Sarsfield,26,28,12,14
2022,128,Liga Profesional Argentina,863228,2022-06-25T18:30:00+00:00,2nd Phase - 5,456,Talleres Cordoba,1065,Central Cordoba de Santiago,0,2,Talleres Cordoba,13,35,Central Cordoba de Santiago,16,34,1,3
2022,128,Liga Profesional Argentina,863237,2022-06-25T21:00:00+00:00,2nd Phase - 5,448,Colon Santa Fe,445,Huracan,0,1,Colon Santa Fe,25,29,Huracan,4,47,-18,-21
2022,128,Liga Profesional Argentina,863230,2022-06-25T21:00:00+00:00,2nd Phase - 5,450,Estudiantes L.P.,457,Newells Old Boys,0,2,Estudiantes L.P.,18,33,Newells Old Boys,11,40,-7,-7
2022,128,Liga Profesional Argentina,863238,2022-06-25T23:30:00+00:00,2nd Phase - 5,435,River Plate,446,Lanus,2,1,River Plate,3,47,Lanus,27,21,26,24
2022,128,Liga Profesional Argentina,863227,2022-06-26T16:00:00+00:00,2nd Phase - 5,460,San Lorenzo,452,Tigre,1,1,San Lorenzo,6,43,Tigre,7,43,0,1
2022,128,Liga Profesional Argentina,863232,2022-06-26T18:30:00+00:00,2nd Phase - 5,1064,Platense,474,Sarmiento Junin,0,0,Platense,19,32,Sarmiento Junin,21,32,0,2
2022,128,Liga Profesional Argentina,863233,2022-06-26T21:00:00+00:00,2nd Phase - 5,436,Racing Club,463,Aldosivi,5,0,Racing Club,2,50,Aldosivi,28,16,34,26
2022,128,Liga Profesional Argentina,863229,2022-06-26T23:30:00+00:00,2nd Phase - 5,458,Argentinos JRS,459,Arsenal Sarandi,1,1,Argentinos JRS,8,42,Arsenal Sarandi,23,30,12,15
2022,128,Liga Profesional Argentina,863231,2022-06-27T18:30:00+00:00,2nd Phase - 5,444,Patronato,453,Independiente,3,1,Patronato,10,40,Independiente,14,35,5,4
2022,128,Liga Profesional Argentina,863236,2022-06-27T23:00:00+00:00,2nd Phase - 5,455,Atletico Tucuman,439,Godoy Cruz,1,1,Atletico Tucuman,5,46,Godoy Cruz,15,35,11,10
2022,128,Liga Profesional Argentina,863249,2022-07-01T22:00:00+00:00,2nd Phase - 6,1065,Central Cordoba de Santiago,458,Argentinos JRS,1,2,Central Cordoba de Santiago,16,34,Argentinos JRS,8,42,-8,-8
2022,128,Liga Profesional Argentina,863252,2022-07-02T00:30:00+00:00,2nd Phase - 6,451,Boca Juniors,449,Banfield,0,3,Boca Juniors,1,52,Banfield,24,30,22,23
2022,128,Liga Profesional Argentina,863250,2022-07-02T18:30:00+00:00,2nd Phase - 6,452,Tigre,456,Talleres Cordoba,1,1,Tigre,7,43,Talleres Cordoba,13,35,8,6
2022,128,Liga Profesional Argentina,863242,2022-07-02T21:00:00+00:00,2nd Phase - 6,438,Velez Sarsfield,455,Atletico Tucuman,0,1,Velez Sarsfield,26,28,Atletico Tucuman,5,46,-18,-21
2022,128,Liga Profesional Argentina,863241,2022-07-02T21:00:00+00:00,2nd Phase - 6,439,Godoy Cruz,448,Colon Santa Fe,1,0,Godoy Cruz,15,35,Colon Santa Fe,25,29,6,10
2022,128,Liga Profesional Argentina,863243,2022-07-02T23:30:00+00:00,2nd Phase - 6,434,Gimnasia L.P.,442,Defensa Y Justicia,1,0,Gimnasia L.P.,9,41,Defensa Y Justicia,12,40,1,3
2022,128,Liga Profesional Argentina,863239,2022-07-03T16:00:00+00:00,2nd Phase - 6,441,Union Santa Fe,446,Lanus,3,0,Union Santa Fe,22,32,Lanus,27,21,11,5
2022,128,Liga Profesional Argentina,863251,2022-07-03T18:00:00+00:00,2nd Phase - 6,2432,Barracas Central,460,San Lorenzo,2,1,Barracas Central,17,34,San Lorenzo,6,43,-9,-11
2022,128,Liga Profesional Argentina,863245,2022-07-03T21:00:00+00:00,2nd Phase - 6,474,Sarmiento Junin,436,Racing Club,1,1,Sarmiento Junin,21,32,Racing Club,2,50,-18,-19
2022,128,Liga Profesional Argentina,863240,2022-07-04T00:00:00+00:00,2nd Phase - 6,445,Huracan,435,River Plate,3,2,Huracan,4,47,River Plate,3,47,0,-1
2022,128,Liga Profesional Argentina,863248,2022-07-04T20:00:00+00:00,2nd Phase - 6,459,Arsenal Sarandi,450,Estudiantes L.P.,2,1,Arsenal Sarandi,23,30,Estudiantes L.P.,18,33,-3,-5
2022,128,Liga Profesional Argentina,863247,2022-07-04T22:00:00+00:00,2nd Phase - 6,457,Newells Old Boys,444,Patronato,2,2,Newells Old Boys,11,40,Patronato,10,40,0,-1
2022,128,Liga Profesional Argentina,863244,2022-07-04T22:00:00+00:00,2nd Phase - 6,463,Aldosivi,437,Rosario Central,2,1,Aldosivi,28,16,Rosario Central,20,32,-16,-8
2022,128,Liga Profesional Argentina,863246,2022-07-05T00:30:00+00:00,2nd Phase - 6,453,Independiente,1064,Platense,1,3,Independiente,14,35,Platense,19,32,3,5
2022,128,Liga Profesional Argentina,863261,2022-07-08T23:00:00+00:00,2nd Phase - 7,437,Rosario Central,474,Sarmiento Junin,1,0,Rosario Central,20,32,Sarmiento Junin,21,32,0,1
2022,128,Liga Profesional Argentina,863258,2022-07-09T16:00:00+00:00,2nd Phase - 7,444,Patronato,459,Arsenal Sarandi,0,1,Patronato,10,40,Arsenal Sarandi,23,30,10,13
2022,128,Liga Profesional Argentina,863254,2022-07-09T18:30:00+00:00,2nd Phase - 7,460,San Lorenzo,451,Boca Juniors,2,1,San Lorenzo,6,43,Boca Juniors,1,52,-9,-5
2022,128,Liga Profesional Argentina,863253,2022-07-09T21:00:00+00:00,2nd Phase - 7,449,Banfield,441,Union Santa Fe,2,3,Banfield,24,30,Union Santa Fe,22,32,-2,-2
2022,128,Liga Profesional Argentina,863255,2022-07-09T23:30:00+00:00,2nd Phase - 7,456,Talleres Cordoba,2432,Barracas Central,0,2,Talleres Cordoba,13,35,Barracas Central,17,34,1,4
2022,128,Liga Profesional Argentina,863259,2022-07-09T23:30:00+00:00,2nd Phase - 7,1064,Platense,457,Newells Old Boys,1,1,Platense,19,32,Newells Old Boys,11,40,-8,-8
2022,128,Liga Profesional Argentina,863257,2022-07-10T16:00:00+00:00,2nd Phase - 7,450,Estudiantes L.P.,1065,Central Cordoba de Santiago,2,2,Estudiantes L.P.,18,33,Central Cordoba de Santiago,16,34,-1,-2
2022,128,Liga Profesional Argentina,863260,2022-07-10T18:30:00+00:00,2nd Phase - 7,436,Racing Club,453,Independiente,1,0,Racing Club,2,50,Independiente,14,35,15,12
2022,128,Liga Profesional Argentina,863266,2022-07-10T21:00:00+00:00,2nd Phase - 7,446,Lanus,445,Huracan,2,3,Lanus,27,21,Huracan,4,47,-26,-23
2022,128,Liga Profesional Argentina,863263,2022-07-10T21:00:00+00:00,2nd Phase - 7,455,Atletico Tucuman,434,Gimnasia L.P.,2,0,Atletico Tucuman,5,46,Gimnasia L.P.,9,41,5,4
2022,128,Liga Profesional Argentina,863265,2022-07-10T23:30:00+00:00,2nd Phase - 7,435,River Plate,439,Godoy Cruz,0,2,River Plate,3,47,Godoy Cruz,15,35,12,12
2022,128,Liga Profesional Argentina,863262,2022-07-11T22:00:00+00:00,2nd Phase - 7,442,Defensa Y Justicia,463,Aldosivi,3,2,Defensa Y Justicia,12,40,Aldosivi,28,16,24,16
2022,128,Liga Profesional Argentina,863264,2022-07-11T22:00:00+00:00,2nd Phase - 7,448,Colon Santa Fe,438,Velez Sarsfield,2,1,Colon Santa Fe,25,29,Velez Sarsfield,26,28,1,1
2022,128,Liga Profesional Argentina,863256,2022-07-12T00:30:00+00:00,2nd Phase - 7,458,Argentinos JRS,452,Tigre,2,1,Argentinos JRS,8,42,Tigre,7,43,-1,-1
2022,128,Liga Profesional Argentina,863276,2022-07-15T00:00:00+00:00,2nd Phase - 8,1065,Central Cordoba de Santiago,444,Patronato,1,3,Central Cordoba de Santiago,16,34,Patronato,10,40,-6,-6
2022,128,Liga Profesional Argentina,863272,2022-07-15T22:00:00+00:00,2nd Phase - 8,474,Sarmiento Junin,442,Defensa Y Justicia,2,0,Sarmiento Junin,21,32,Defensa Y Justicia,12,40,-8,-9
2022,128,Liga Profesional Argentina,863275,2022-07-16T00:30:00+00:00,2nd Phase - 8,459,Arsenal Sarandi,1064,Platense,1,1,Arsenal Sarandi,23,30,Platense,19,32,-2,-4
2022,128,Liga Profesional Argentina,863271,2022-07-16T00:30:00+00:00,2nd Phase - 8,463,Aldosivi,455,Atletico Tucuman,0,1,Aldosivi,28,16,Atletico Tucuman,5,46,-30,-23
2022,128,Liga Profesional Argentina,863278,2022-07-16T16:00:00+00:00,2nd Phase - 8,2432,Barracas Central,458,Argentinos JRS,1,3,Barracas Central,17,34,Argentinos JRS,8,42,-8,-9
2022,128,Liga Profesional Argentina,863270,2022-07-16T18:30:00+00:00,2nd Phase - 8,434,Gimnasia L.P.,448,Colon Santa Fe,0,0,Gimnasia L.P.,9,41,Colon Santa Fe,25,29,12,16
2022,128,Liga Profesional Argentina,863273,2022-07-16T18:30:00+00:00,2nd Phase - 8,453,Independiente,437,Rosario Central,0,0,Independiente,14,35,Rosario Central,20,32,3,6
2022,128,Liga Profesional Argentina,863274,2022-07-16T21:00:00+00:00,2nd Phase - 8,457,Newells Old Boys,436,Racing Club,0,0,Newells Old Boys,11,40,Racing Club,2,50,-10,-9
2022,128,Liga Profesional Argentina,863279,2022-07-16T23:30:00+00:00,2nd Phase - 8,451,Boca Juniors,456,Talleres Cordoba,1,0,Boca Juniors,1,52,Talleres Cordoba,13,35,17,12
2022,128,Liga Profesional Argentina,863268,2022-07-17T16:00:00+00:00,2nd Phase - 8,439,Godoy Cruz,446,Lanus,2,1,Godoy Cruz,15,35,Lanus,27,21,14,12
2022,128,Liga Profesional Argentina,863267,2022-07-17T16:00:00+00:00,2nd Phase - 8,441,Union Santa Fe,445,Huracan,0,0,Union Santa Fe,22,32,Huracan,4,47,-15,-18
2022,128,Liga Profesional Argentina,863280,2022-07-17T18:30:00+00:00,2nd Phase - 8,449,Banfield,460,San Lorenzo,1,1,Banfield,24,30,San Lorenzo,6,43,-13,-18
2022,128,Liga Profesional Argentina,863277,2022-07-17T21:00:00+00:00,2nd Phase - 8,452,Tigre,450,Estudiantes L.P.,2,1,Tigre,7,43,Estudiantes L.P.,18,33,10,11
2022,128,Liga Profesional Argentina,863269,2022-07-17T23:30:00+00:00,2nd Phase - 8,438,Velez Sarsfield,435,River Plate,2,2,Velez Sarsfield,26,28,River Plate,3,47,-19,-23
2022,128,Liga Profesional Argentina,863291,2022-07-19T19:30:00+00:00,2nd Phase - 9,448,Colon Santa Fe,463,Aldosivi,1,1,Colon Santa Fe,25,29,Aldosivi,28,16,13,3
2022,128,Liga Profesional Argentina,863286,2022-07-19T19:30:00+00:00,2nd Phase - 9,1064,Platense,1065,Central Cordoba de Santiago,2,0,Platense,19,32,Central Cordoba de Santiago,16,34,-2,-3
2022,128,Liga Profesional Argentina,863287,2022-07-19T22:00:00+00:00,2nd Phase - 9,436,Racing Club,459,Arsenal Sarandi,1,1,Racing Club,2,50,Arsenal Sarandi,23,30,20,21
2022,128,Liga Profesional Argentina,863290,2022-07-19T22:00:00+00:00,2nd Phase - 9,455,Atletico Tucuman,474,Sarmiento Junin,1,0,Atletico Tucuman,5,46,Sarmiento Junin,21,32,14,16
2022,128,Liga Profesional Argentina,863283,2022-07-20T00:30:00+00:00,2nd Phase - 9,458,Argentinos JRS,451,Boca Juniors,2,0,Argentinos JRS,8,42,Boca Juniors,1,52,-10,-7
2022,128,Liga Profesional Argentina,863281,2022-07-20T17:00:00+00:00,2nd Phase - 9,460,San Lorenzo,441,Union Santa Fe,2,2,San Lorenzo,6,43,Union Santa Fe,22,32,11,16
2022,128,Liga Profesional Argentina,863285,2022-07-20T19:30:00+00:00,2nd Phase - 9,444,Patronato,452,Tigre,1,0,Patronato,10,40,Tigre,7,43,-3,-3
2022,128,Liga Profesional Argentina,863289,2022-07-20T22:00:00+00:00,2nd Phase - 9,442,Defensa Y Justicia,453,Independiente,2,1,Defensa Y Justicia,12,40,Independiente,14,35,5,2
2022,128,Liga Profesional Argentina,863284,2022-07-20T22:00:00+00:00,2nd Phase - 9,450,Estudiantes L.P.,2432,Barracas Central,3,1,Estudiantes L.P.,18,33,Barracas Central,17,34,-1,-1
2022,128,Liga Profesional Argentina,863294,2022-07-21T00:30:00+00:00,2nd Phase - 9,445,Huracan,439,Godoy Cruz,0,0,Huracan,4,47,Godoy Cruz,15,35,12,11
2022,128,Liga Profesional Argentina,863293,2022-07-21T00:30:00+00:00,2nd Phase - 9,446,Lanus,438,Velez Sarsfield,2,2,Lanus,27,21,Velez Sarsfield,26,28,-7,-1
2022,128,Liga Profesional Argentina,863288,2022-07-21T19:30:00+00:00,2nd Phase - 9,437,Rosario Central,457,Newells Old Boys,1,0,Rosario Central,20,32,Newells Old Boys,11,40,-8,-9
2022,128,Liga Profesional Argentina,863282,2022-07-21T22:00:00+00:00,2nd Phase - 9,456,Talleres Cordoba,449,Banfield,1,0,Talleres Cordoba,13,35,Banfield,24,30,5,11
2022,128,Liga Profesional Argentina,863292,2022-07-22T00:30:00+00:00,2nd Phase - 9,435,River Plate,434,Gimnasia L.P.,1,0,River Plate,3,47,Gimnasia L.P.,9,41,6,6
2022,128,Liga Profesional Argentina,863299,2022-07-23T18:30:00+00:00,2nd Phase - 10,474,Sarmiento Junin,448,Colon Santa Fe,1,3,Sarmiento Junin,21,32,Colon Santa Fe,25,29,3,4
2022,128,Liga Profesional Argentina,863303,2022-07-23T23:30:00+00:00,2nd Phase - 10,1065,Central Cordoba de Santiago,436,Racing Club,1,3,Central Cordoba de Santiago,16,34,Racing Club,2,50,-16,-14
2022,128,Liga Profesional Argentina,863300,2022-07-24T14:00:00+00:00,2nd Phase - 10,453,Independiente,455,Atletico Tucuman,0,1,Independiente,14,35,Atletico Tucuman,5,46,-11,-9
2022,128,Liga Profesional Argentina,863304,2022-07-24T16:00:00+00:00,2nd Phase - 10,452,Tigre,1064,Platense,3,0,Tigre,7,43,Platense,19,32,11,12
2022,128,Liga Profesional Argentina,863298,2022-07-24T18:30:00+00:00,2nd Phase - 10,463,Aldosivi,435,River Plate,0,3,Aldosivi,28,16,River Plate,3,47,-31,-25
2022,128,Liga Profesional Argentina,863297,2022-07-24T21:00:00+00:00,2nd Phase - 10,434,Gimnasia L.P.,446,Lanus,1,0,Gimnasia L.P.,9,41,Lanus,27,21,20,18
2022,128,Liga Profesional Argentina,863306,2022-07-24T23:30:00+00:00,2nd Phase - 10,451,Boca Juniors,450,Estudiantes L.P.,3,1,Boca Juniors,1,52,Estudiantes L.P.,18,33,19,17
2022,128,Liga Profesional Argentina,863308,2022-07-25T19:30:00+00:00,2nd Phase - 10,460,San Lorenzo,456,Talleres Cordoba,1,1,San Lorenzo,6,43,Talleres Cordoba,13,35,8,7
2022,128,Liga Profesional Argentina,863307,2022-07-25T22:00:00+00:00,2nd Phase - 10,449,Banfield,458,Argentinos JRS,1,1,Banfield,24,30,Argentinos JRS,8,42,-12,-16
2022,128,Liga Profesional Argentina,863301,2022-07-25T22:00:00+00:00,2nd Phase - 10,457,Newells Old Boys,442,Defensa Y Justicia,1,2,Newells Old Boys,11,40,Defensa Y Justicia,12,40,0,1
2022,128,Liga Profesional Argentina,863296,2022-07-26T00:30:00+00:00,2nd Phase - 10,438,Velez Sarsfield,445,Huracan,1,1,Velez Sarsfield,26,28,Huracan,4,47,-19,-22
2022,128,Liga Profesional Argentina,863295,2022-07-26T00:30:00+00:00,2nd Phase - 10,441,Union Santa Fe,439,Godoy Cruz,2,1,Union Santa Fe,22,32,Godoy Cruz,15,35,-3,-7
2022,128,Liga Profesional Argentina,863302,2022-07-26T23:00:00+00:00,2nd Phase - 10,459,Arsenal Sarandi,437,Rosario Central,0,3,Arsenal Sarandi,23,30,Rosario Central,20,32,-2,-3
2022,128,Liga Profesional Argentina,863305,2022-07-26T23:00:00+00:00,2nd Phase - 10,2432,Barracas Central,444,Patronato,2,1,Barracas Central,17,34,Patronato,10,40,-6,-7
2022,128,Liga Profesional Argentina,863322,2022-07-29T23:00:00+00:00,2nd Phase - 11,439,Godoy Cruz,438,Velez Sarsfield,1,1,Godoy Cruz,15,35,Velez Sarsfield,26,28,7,11
2022,128,Liga Profesional Argentina,863310,2022-07-30T18:30:00+00:00,2nd Phase - 11,458,Argentinos JRS,460,San Lorenzo,0,1,Argentinos JRS,8,42,San Lorenzo,6,43,-1,-2
2022,128,Liga Profesional Argentina,863311,2022-07-30T21:00:00+00:00,2nd Phase - 11,450,Estudiantes L.P.,449,Banfield,0,0,Estudiantes L.P.,18,33,Banfield,24,30,3,6
2022,128,Liga Profesional Argentina,863321,2022-07-30T23:30:00+00:00,2nd Phase - 11,445,Huracan,434,Gimnasia L.P.,0,1,Huracan,4,47,Gimnasia L.P.,9,41,6,5
2022,128,Liga Profesional Argentina,863317,2022-07-30T23:30:00+00:00,2nd Phase - 11,455,Atletico Tucuman,457,Newells Old Boys,2,0,Atletico Tucuman,5,46,Newells Old Boys,11,40,6,6
2022,128,Liga Profesional Argentina,863320,2022-07-31T16:00:00+00:00,2nd Phase - 11,446,Lanus,463,Aldosivi,0,1,Lanus,27,21,Aldosivi,28,16,5,1
2022,128,Liga Profesional Argentina,863313,2022-07-31T16:00:00+00:00,2nd Phase - 11,1064,Platense,2432,Barracas Central,0,0,Platense,19,32,Barracas Central,17,34,-2,-2
2022,128,Liga Profesional Argentina,863314,2022-07-31T18:30:00+00:00,2nd Phase - 11,436,Racing Club,452,Tigre,3,3,Racing Club,2,50,Tigre,7,43,7,5
2022,128,Liga Profesional Argentina,863312,2022-07-31T21:00:00+00:00,2nd Phase - 11,444,Patronato,451,Boca Juniors,3,0,Patronato,10,40,Boca Juniors,1,52,-12,-9
2022,128,Liga Profesional Argentina,863319,2022-07-31T23:30:00+00:00,2nd Phase - 11,435,River Plate,474,Sarmiento Junin,1,2,River Plate,3,47,Sarmiento Junin,21,32,15,18
2022,128,Liga Profesional Argentina,863315,2022-08-01T22:00:00+00:00,2nd Phase - 11,437,Rosario Central,1065,Central Cordoba de Santiago,0,3,Rosario Central,20,32,Central Cordoba de Santiago,16,34,-2,-4
2022,128,Liga Profesional Argentina,863316,2022-08-01T22:00:00+00:00,2nd Phase - 11,442,Defensa Y Justicia,459,Arsenal Sarandi,0,0,Defensa Y Justicia,12,40,Arsenal Sarandi,23,30,10,11
2022,128,Liga Profesional Argentina,863318,2022-08-02T00:30:00+00:00,2nd Phase - 11,448,Colon Santa Fe,453,Independiente,0,3,Colon Santa Fe,25,29,Independiente,14,35,-6,-11
2022,128,Liga Profesional Argentina,863324,2022-08-05T22:00:00+00:00,2nd Phase - 12,434,Gimnasia L.P.,439,Godoy Cruz,2,0,Gimnasia L.P.,9,41,Godoy Cruz,15,35,6,6
2022,128,Liga Profesional Argentina,863334,2022-08-06T00:30:00+00:00,2nd Phase - 12,449,Banfield,444,Patronato,0,0,Banfield,24,30,Patronato,10,40,-10,-14
2022,128,Liga Profesional Argentina,863326,2022-08-06T00:30:00+00:00,2nd Phase - 12,474,Sarmiento Junin,446,Lanus,2,1,Sarmiento Junin,21,32,Lanus,27,21,11,6
2022,128,Liga Profesional Argentina,863329,2022-08-06T16:00:00+00:00,2nd Phase - 12,459,Arsenal Sarandi,455,Atletico Tucuman,3,1,Arsenal Sarandi,23,30,Atletico Tucuman,5,46,-16,-18
2022,128,Liga Profesional Argentina,863332,2022-08-06T18:00:00+00:00,2nd Phase - 12,2432,Barracas Central,436,Racing Club,0,0,Barracas Central,17,34,Racing Club,2,50,-16,-15
2022,128,Liga Profesional Argentina,863323,2022-08-06T21:00:00+00:00,2nd Phase - 12,441,Union Santa Fe,438,Velez Sarsfield,2,1,Union Santa Fe,22,32,Velez Sarsfield,26,28,4,4
2022,128,Liga Profesional Argentina,863336,2022-08-06T21:00:00+00:00,2nd Phase - 12,456,Talleres Cordoba,458,Argentinos JRS,2,0,Talleres Cordoba,13,35,Argentinos JRS,8,42,-7,-5
2022,128,Liga Profesional Argentina,863333,2022-08-07T00:00:00+00:00,2nd Phase - 12,451,Boca Juniors,1064,Platense,2,1,Boca Juniors,1,52,Platense,19,32,20,18
2022,128,Liga Profesional Argentina,863325,2022-08-07T16:00:00+00:00,2nd Phase - 12,463,Aldosivi,445,Huracan,0,1,Aldosivi,28,16,Huracan,4,47,-31,-24
2022,128,Liga Profesional Argentina,863335,2022-08-07T18:00:00+00:00,2nd Phase - 12,460,San Lorenzo,450,Estudiantes L.P.,0,0,San Lorenzo,6,43,Estudiantes L.P.,18,33,10,12
2022,128,Liga Profesional Argentina,863327,2022-08-07T20:30:00+00:00,2nd Phase - 12,453,Independiente,435,River Plate,0,1,Independiente,14,35,River Plate,3,47,-12,-11
2022,128,Liga Profesional Argentina,863328,2022-08-07T23:00:00+00:00,2nd Phase - 12,457,Newells Old Boys,448,Colon Santa Fe,0,0,Newells Old Boys,11,40,Colon Santa Fe,25,29,11,14
2022,128,Liga Profesional Argentina,863330,2022-08-08T14:00:00+00:00,2nd Phase - 12,1065,Central Cordoba de Santiago,442,Defensa Y Justicia,1,0,Central Cordoba de Santiago,16,34,Defensa Y Justicia,12,40,-6,-4
2022,128,Liga Profesional Argentina,863331,2022-08-08T23:00:00+00:00,2nd Phase - 12,452,Tigre,437,Rosario Central,3,1,Tigre,7,43,Rosario Central,20,32,11,13
2022,128,Liga Profesional Argentina,863349,2022-08-11T22:00:00+00:00,2nd Phase - 13,439,Godoy Cruz,463,Aldosivi,2,0,Godoy Cruz,15,35,Aldosivi,28,16,19,13
2022,128,Liga Profesional Argentina,863345,2022-08-12T00:30:00+00:00,2nd Phase - 13,448,Colon Santa Fe,459,Arsenal Sarandi,1,1,Colon Santa Fe,25,29,Arsenal Sarandi,23,30,-1,-2
2022,128,Liga Profesional Argentina,863344,2022-08-12T00:30:00+00:00,2nd Phase - 13,455,Atletico Tucuman,1065,Central Cordoba de Santiago,1,0,Atletico Tucuman,5,46,Central Cordoba de Santiago,16,34,12,11
2022,128,Liga Profesional Argentina,863348,2022-08-12T22:00:00+00:00,2nd Phase - 13,445,Huracan,474,Sarmiento Junin,4,1,Huracan,4,47,Sarmiento Junin,21,32,15,17
2022,128,Liga Profesional Argentina,863340,2022-08-12T22:00:00+00:00,2nd Phase - 13,1064,Platense,449,Banfield,3,1,Platense,19,32,Banfield,24,30,2,5
2022,128,Liga Profesional Argentina,863339,2022-08-13T00:30:00+00:00,2nd Phase - 13,444,Patronato,460,San Lorenzo,3,2,Patronato,10,40,San Lorenzo,6,43,-3,-4
2022,128,Liga Profesional Argentina,863342,2022-08-13T18:30:00+00:00,2nd Phase - 13,437,Rosario Central,2432,Barracas Central,3,1,Rosario Central,20,32,Barracas Central,17,34,-2,-3
2022,128,Liga Profesional Argentina,863343,2022-08-13T18:30:00+00:00,2nd Phase - 13,442,Defensa Y Justicia,452,Tigre,0,0,Defensa Y Justicia,12,40,Tigre,7,43,-3,-5
2022,128,Liga Profesional Argentina,863347,2022-08-13T21:00:00+00:00,2nd Phase - 13,446,Lanus,453,Independiente,1,1,Lanus,27,21,Independiente,14,35,-14,-13
2022,128,Liga Profesional Argentina,863346,2022-08-13T23:30:00+00:00,2nd Phase - 13,435,River Plate,457,Newells Old Boys,4,1,River Plate,3,47,Newells Old Boys,11,40,7,8
2022,128,Liga Profesional Argentina,863350,2022-08-14T18:30:00+00:00,2nd Phase - 13,438,Velez Sarsfield,434,Gimnasia L.P.,1,1,Velez Sarsfield,26,28,Gimnasia L.P.,9,41,-13,-17
2022,128,Liga Profesional Argentina,863338,2022-08-14T21:00:00+00:00,2nd Phase - 13,450,Estudiantes L.P.,456,Talleres Cordoba,1,0,Estudiantes L.P.,18,33,Talleres Cordoba,13,35,-2,-5
2022,128,Liga Profesional Argentina,863337,2022-08-14T21:00:00+00:00,2nd Phase - 13,458,Argentinos JRS,441,Union Santa Fe,2,0,Argentinos JRS,8,42,Union Santa Fe,22,32,10,14
2022,128,Liga Profesional Argentina,863341,2022-08-14T23:30:00+00:00,2nd Phase - 13,436,Racing Club,451,Boca Juniors,0,0,Racing Club,2,50,Boca Juniors,1,52,-2,-1
2022,128,Liga Profesional Argentina,863353,2022-08-16T19:30:00+00:00,2nd Phase - 14,474,Sarmiento Junin,439,Godoy Cruz,1,2,Sarmiento Junin,21,32,Godoy Cruz,15,35,-3,-6
2022,128,Liga Profesional Argentina,863357,2022-08-16T19:30:00+00:00,2nd Phase - 14,1065,Central Cordoba de Santiago,448,Colon Santa Fe,3,0,Central Cordoba de Santiago,16,34,Colon Santa Fe,25,29,5,9
2022,128,Liga Profesional Argentina,863362,2022-08-16T22:00:00+00:00,2nd Phase - 14,460,San Lorenzo,1064,Platense,2,0,San Lorenzo,6,43,Platense,19,32,11,13
2022,128,Liga Profesional Argentina,863354,2022-08-17T00:30:00+00:00,2nd Phase - 14,453,Independiente,445,Huracan,1,1,Independiente,14,35,Huracan,4,47,-12,-10
2022,128,Liga Profesional Argentina,863358,2022-08-17T19:30:00+00:00,2nd Phase - 14,452,Tigre,455,Atletico Tucuman,0,0,Tigre,7,43,Atletico Tucuman,5,46,-3,-2
2022,128,Liga Profesional Argentina,863355,2022-08-17T19:30:00+00:00,2nd Phase - 14,457,Newells Old Boys,446,Lanus,2,0,Newells Old Boys,11,40,Lanus,27,21,19,16
2022,128,Liga Profesional Argentina,863356,2022-08-17T22:00:00+00:00,2nd Phase - 14,459,Arsenal Sarandi,435,River Plate,0,0,Arsenal Sarandi,23,30,River Plate,3,47,-17,-20
2022,128,Liga Profesional Argentina,863360,2022-08-18T00:30:00+00:00,2nd Phase - 14,451,Boca Juniors,437,Rosario Central,0,0,Boca Juniors,1,52,Rosario Central,20,32,20,19
2022,128,Liga Profesional Argentina,863359,2022-08-18T17:30:00+00:00,2nd Phase - 14,2432,Barracas Central,442,Defensa Y Justicia,3,1,Barracas Central,17,34,Defensa Y Justicia,12,40,-6,-5
2022,128,Liga Profesional Argentina,863352,2022-08-18T19:30:00+00:00,2nd Phase - 14,463,Aldosivi,438,Velez Sarsfield,3,2,Aldosivi,28,16,Velez Sarsfield,26,28,-12,-2
2022,128,Liga Profesional Argentina,863351,2022-08-18T22:00:00+00:00,2nd Phase - 14,441,Union Santa Fe,434,Gimnasia L.P.,0,2,Union Santa Fe,22,32,Gimnasia L.P.,9,41,-9,-13
2022,128,Liga Profesional Argentina,863363,2022-08-18T22:00:00+00:00,2nd Phase - 14,456,Talleres Cordoba,444,Patronato,3,3,Talleres Cordoba,13,35,Patronato,10,40,-5,-3
2022,128,Liga Profesional Argentina,863361,2022-08-19T00:30:00+00:00,2nd Phase - 14,449,Banfield,436,Racing Club,0,2,Banfield,24,30,Racing Club,2,50,-20,-22
2022,128,Liga Profesional Argentina,863364,2022-08-19T00:30:00+00:00,2nd Phase - 14,458,Argentinos JRS,450,Estudiantes L.P.,1,0,Argentinos JRS,8,42,Estudiantes L.P.,18,33,9,10
2022,128,Liga Profesional Argentina,863372,2022-08-20T21:00:00+00:00,2nd Phase - 15,448,Colon Santa Fe,452,Tigre,2,1,Colon Santa Fe,25,29,Tigre,7,43,-14,-18
2022,128,Liga Profesional Argentina,863375,2022-08-20T23:30:00+00:00,2nd Phase - 15,445,Huracan,457,Newells Old Boys,1,0,Huracan,4,47,Newells Old Boys,11,40,7,7
2022,128,Liga Profesional Argentina,863374,2022-08-21T16:00:00+00:00,2nd Phase - 15,446,Lanus,459,Arsenal Sarandi,1,0,Lanus,27,21,Arsenal Sarandi,23,30,-9,-4
2022,128,Liga Profesional Argentina,863376,2022-08-21T18:30:00+00:00,2nd Phase - 15,439,Godoy Cruz,453,Independiente,1,1,Godoy Cruz,15,35,Independiente,14,35,0,-1
2022,128,Liga Profesional Argentina,863373,2022-08-21T21:00:00+00:00,2nd Phase - 15,435,River Plate,1065,Central Cordoba de Santiago,3,0,River Plate,3,47,Central Cordoba de Santiago,16,34,13,13
2022,128,Liga Profesional Argentina,863370,2022-08-21T23:30:00+00:00,2nd Phase - 15,442,Defensa Y Justicia,451,Boca Juniors,0,1,Defensa Y Justicia,12,40,Boca Juniors,1,52,-12,-11
2022,128,Liga Profesional Argentina,863369,2022-08-22T19:30:00+00:00,2nd Phase - 15,437,Rosario Central,449,Banfield,0,1,Rosario Central,20,32,Banfield,24,30,2,4
2022,128,Liga Profesional Argentina,863365,2022-08-22T19:30:00+00:00,2nd Phase - 15,450,Estudiantes L.P.,441,Union Santa Fe,1,0,Estudiantes L.P.,18,33,Union Santa Fe,22,32,1,4
2022,128,Liga Profesional Argentina,863368,2022-08-22T22:00:00+00:00,2nd Phase - 15,436,Racing Club,460,San Lorenzo,1,2,Racing Club,2,50,San Lorenzo,6,43,7,4
2022,128,Liga Profesional Argentina,863377,2022-08-23T00:30:00+00:00,2nd Phase - 15,438,Velez Sarsfield,474,Sarmiento Junin,1,1,Velez Sarsfield,26,28,Sarmiento Junin,21,32,-4,-5
2022,128,Liga Profesional Argentina,863367,2022-08-23T00:30:00+00:00,2nd Phase - 15,1064,Platense,456,Talleres Cordoba,0,0,Platense,19,32,Talleres Cordoba,13,35,-3,-6
2022,128,Liga Profesional Argentina,863366,2022-08-23T22:00:00+00:00,2nd Phase - 15,444,Patronato,458,Argentinos JRS,0,0,Patronato,10,40,Argentinos JRS,8,42,-2,-2
2022,128,Liga Profesional Argentina,863378,2022-08-24T00:30:00+00:00,2nd Phase - 15,434,Gimnasia L.P.,463,Aldosivi,0,0,Gimnasia L.P.,9,41,Aldosivi,28,16,25,19
2022,128,Liga Profesional Argentina,863371,2022-08-24T00:30:00+00:00,2nd Phase - 15,455,Atletico Tucuman,2432,Barracas Central,4,0,Atletico Tucuman,5,46,Barracas Central,17,34,12,12
2022,128,Liga Profesional Argentina,863384,2022-08-26T21:00:00+00:00,2nd Phase - 16,1065,Central Cordoba de Santiago,446,Lanus,2,2,Central Cordoba de Santiago,16,34,Lanus,27,21,13,11
2022,128,Liga Profesional Argentina,863383,2022-08-27T00:00:00+00:00,2nd Phase - 16,459,Arsenal Sarandi,445,Huracan,1,1,Arsenal Sarandi,23,30,Huracan,4,47,-17,-19
2022,128,Liga Profesional Argentina,863389,2022-08-27T16:00:00+00:00,2nd Phase - 16,460,San Lorenzo,437,Rosario Central,1,1,San Lorenzo,6,43,Rosario Central,20,32,11,14
2022,128,Liga Profesional Argentina,863388,2022-08-27T18:30:00+00:00,2nd Phase - 16,449,Banfield,442,Defensa Y Justicia,1,2,Banfield,24,30,Defensa Y Justicia,12,40,-10,-12
2022,128,Liga Profesional Argentina,863382,2022-08-27T18:30:00+00:00,2nd Phase - 16,457,Newells Old Boys,439,Godoy Cruz,1,2,Newells Old Boys,11,40,Godoy Cruz,15,35,5,4
2022,128,Liga Profesional Argentina,863390,2022-08-27T21:00:00+00:00,2nd Phase - 16,456,Talleres Cordoba,436,Racing Club,1,1,Talleres Cordoba,13,35,Racing Club,2,50,-15,-11
2022,128,Liga Profesional Argentina,863391,2022-08-27T21:00:00+00:00,2nd Phase - 16,458,Argentinos JRS,1064,Platense,0,2,Argentinos JRS,8,42,Platense,19,32,10,11
2022,128,Liga Profesional Argentina,863385,2022-08-27T23:30:00+00:00,2nd Phase - 16,452,Tigre,435,River Plate,1,1,Tigre,7,43,River Plate,3,47,-4,-4
2022,128,Liga Profesional Argentina,863380,2022-08-28T16:00:00+00:00,2nd Phase - 16,474,Sarmiento Junin,434,Gimnasia L.P.,0,0,Sarmiento Junin,21,32,Gimnasia L.P.,9,41,-9,-12
2022,128,Liga Profesional Argentina,863386,2022-08-28T16:00:00+00:00,2nd Phase - 16,2432,Barracas Central,448,Colon Santa Fe,1,0,Barracas Central,17,34,Colon Santa Fe,25,29,5,8
2022,128,Liga Profesional Argentina,863381,2022-08-28T18:30:00+00:00,2nd Phase - 16,453,Independiente,438,Velez Sarsfield,1,1,Independiente,14,35,Velez Sarsfield,26,28,7,12
2022,128,Liga Profesional Argentina,863387,2022-08-28T21:00:00+00:00,2nd Phase - 16,451,Boca Juniors,455,Atletico Tucuman,2,1,Boca Juniors,1,52,Atletico Tucuman,5,46,6,4
2022,128,Liga Profesional Argentina,863379,2022-08-28T23:30:00+00:00,2nd Phase - 16,441,Union Santa Fe,463,Aldosivi,0,0,Union Santa Fe,22,32,Aldosivi,28,16,16,6
2022,128,Liga Profesional Argentina,863392,2022-08-28T23:30:00+00:00,2nd Phase - 16,450,Estudiantes L.P.,444,Patronato,1,0,Estudiantes L.P.,18,33,Patronato,10,40,-7,-8
2022,128,Liga Profesional Argentina,863402,2022-09-01T23:00:00+00:00,2nd Phase - 17,445,Huracan,1065,Central Cordoba de Santiago,2,0,Huracan,4,47,Central Cordoba de Santiago,16,34,13,12
2022,128,Liga Profesional Argentina,863401,2022-09-03T15:00:00+00:00,2nd Phase - 17,446,Lanus,452,Tigre,1,2,Lanus,27,21,Tigre,7,43,-22,-20
2022,128,Liga Profesional Argentina,863396,2022-09-03T16:00:00+00:00,2nd Phase - 17,437,Rosario Central,456,Talleres Cordoba,1,0,Rosario Central,20,32,Talleres Cordoba,13,35,-3,-7
2022,128,Liga Profesional Argentina,863404,2022-09-03T18:30:00+00:00,2nd Phase - 17,438,Velez Sarsfield,457,Newells Old Boys,0,1,Velez Sarsfield,26,28,Newells Old Boys,11,40,-12,-15
2022,128,Liga Profesional Argentina,863406,2022-09-03T18:30:00+00:00,2nd Phase - 17,463,Aldosivi,474,Sarmiento Junin,1,2,Aldosivi,28,16,Sarmiento Junin,21,32,-16,-7
2022,128,Liga Profesional Argentina,863395,2022-09-03T21:00:00+00:00,2nd Phase - 17,436,Racing Club,458,Argentinos JRS,1,0,Racing Club,2,50,Argentinos JRS,8,42,8,6
2022,128,Liga Profesional Argentina,863405,2022-09-03T23:30:00+00:00,2nd Phase - 17,434,Gimnasia L.P.,453,Independiente,3,1,Gimnasia L.P.,9,41,Independiente,14,35,6,5
2022,128,Liga Profesional Argentina,863393,2022-09-04T18:30:00+00:00,2nd Phase - 17,444,Patronato,441,Union Santa Fe,0,0,Patronato,10,40,Union Santa Fe,22,32,8,12
2022,128,Liga Profesional Argentina,863394,2022-09-04T18:30:00+00:00,2nd Phase - 17,1064,Platense,450,Estudiantes L.P.,0,0,Platense,19,32,Estudiantes L.P.,18,33,-1,-1
2022,128,Liga Profesional Argentina,863399,2022-09-04T21:00:00+00:00,2nd Phase - 17,448,Colon Santa Fe,451,Boca Juniors,1,2,Colon Santa Fe,25,29,Boca Juniors,1,52,-23,-24
2022,128,Liga Profesional Argentina,863400,2022-09-04T23:30:00+00:00,2nd Phase - 17,435,River Plate,2432,Barracas Central,2,0,River Plate,3,47,Barracas Central,17,34,13,14
2022,128,Liga Profesional Argentina,863403,2022-09-05T22:00:00+00:00,2nd Phase - 17,439,Godoy Cruz,459,Arsenal Sarandi,1,0,Godoy Cruz,15,35,Arsenal Sarandi,23,30,5,8
2022,128,Liga Profesional Argentina,863397,2022-09-05T22:00:00+00:00,2nd Phase - 17,442,Defensa Y Justicia,460,San Lorenzo,0,0,Defensa Y Justicia,12,40,San Lorenzo,6,43,-3,-6
2022,128,Liga Profesional Argentina,863398,2022-09-06T00:30:00+00:00,2nd Phase - 17,455,Atletico Tucuman,449,Banfield,0,0,Atletico Tucuman,5,46,Banfield,24,30,16,19
2022,128,Liga Profesional Argentina,863408,2022-09-08T21:00:00+00:00,2nd Phase - 18,453,Independiente,463,Aldosivi,3,0,Independiente,14,35,Aldosivi,28,16,19,14
2022,128,Liga Profesional Argentina,863407,2022-09-08T23:30:00+00:00,2nd Phase - 18,441,Union Santa Fe,474,Sarmiento Junin,1,0,Union Santa Fe,22,32,Sarmiento Junin,21,32,0,-1
2022,128,Liga Profesional Argentina,863418,2022-09-08T23:30:00+00:00,2nd Phase - 18,458,Argentinos JRS,437,Rosario Central,2,1,Argentinos JRS,8,42,Rosario Central,20,32,10,12
2022,128,Liga Profesional Argentina,863413,2022-09-09T18:30:00+00:00,2nd Phase - 18,2432,Barracas Central,446,Lanus,2,0,Barracas Central,17,34,Lanus,27,21,13,10
2022,128,Liga Profesional Argentina,863420,2022-09-09T21:00:00+00:00,2nd Phase - 18,444,Patronato,1064,Platense,1,0,Patronato,10,40,Platense,19,32,8,9
2022,128,Liga Profesional Argentina,863419,2022-09-09T23:30:00+00:00,2nd Phase - 18,450,Estudiantes L.P.,436,Racing Club,1,0,Estudiantes L.P.,18,33,Racing Club,2,50,-17,-16
2022,128,Liga Profesional Argentina,863412,2022-09-09T23:30:00+00:00,2nd Phase - 18,452,Tigre,445,Huracan,1,1,Tigre,7,43,Huracan,4,47,-4,-3
2022,128,Liga Profesional Argentina,863411,2022-09-10T18:30:00+00:00,2nd Phase - 18,1065,Central Cordoba de Santiago,439,Godoy Cruz,3,0,Central Cordoba de Santiago,16,34,Godoy Cruz,15,35,-1,-1
2022,128,Liga Profesional Argentina,863416,2022-09-10T21:00:00+00:00,2nd Phase - 18,460,San Lorenzo,455,Atletico Tucuman,1,1,San Lorenzo,6,43,Atletico Tucuman,5,46,-3,-1
2022,128,Liga Profesional Argentina,863415,2022-09-10T23:30:00+00:00,2nd Phase - 18,449,Banfield,448,Colon Santa Fe,2,1,Banfield,24,30,Colon Santa Fe,25,29,1,1
2022,128,Liga Profesional Argentina,863409,2022-09-11T16:00:00+00:00,2nd Phase - 18,457,Newells Old Boys,434,Gimnasia L.P.,2,0,Newells Old Boys,11,40,Gimnasia L.P.,9,41,-1,-2
2022,128,Liga Profesional Argentina,863410,2022-09-11T16:00:00+00:00,2nd Phase - 18,459,Arsenal Sarandi,438,Velez Sarsfield,2,2,Arsenal Sarandi,23,30,Velez Sarsfield,26,28,2,3
2022,128,Liga Profesional Argentina,863414,2022-09-11T20:00:00+00:00,2nd Phase - 18,451,Boca Juniors,435,River Plate,1,0,Boca Juniors,1,52,River Plate,3,47,5,2
2022,128,Liga Profesional Argentina,863417,2022-09-11T23:00:00+00:00,2nd Phase - 18,456,Talleres Cordoba,442,Defensa Y Justicia,1,0,Talleres Cordoba,13,35,Defensa Y Justicia,12,40,-5,-1
2022,128,Liga Profesional Argentina,863434,2022-09-12T20:00:00+00:00,2nd Phase - 19,474,Sarmiento Junin,453,Independiente,1,2,Sarmiento Junin,21,32,Independiente,14,35,-3,-7
2022,128,Liga Profesional Argentina,863430,2022-09-13T22:00:00+00:00,2nd Phase - 19,439,Godoy Cruz,452,Tigre,1,1,Godoy Cruz,15,35,Tigre,7,43,-8,-8
2022,128,Liga Profesional Argentina,863429,2022-09-13T22:00:00+00:00,2nd Phase - 19,445,Huracan,2432,Barracas Central,1,1,Huracan,4,47,Barracas Central,17,34,13,13
2022,128,Liga Profesional Argentina,863422,2022-09-14T00:30:00+00:00,2nd Phase - 19,436,Racing Club,444,Patronato,1,0,Racing Club,2,50,Patronato,10,40,10,8
2022,128,Liga Profesional Argentina,863421,2022-09-14T00:30:00+00:00,2nd Phase - 19,1064,Platense,441,Union Santa Fe,1,0,Platense,19,32,Union Santa Fe,22,32,0,3
2022,128,Liga Profesional Argentina,863433,2022-09-14T17:00:00+00:00,2nd Phase - 19,463,Aldosivi,457,Newells Old Boys,1,2,Aldosivi,28,16,Newells Old Boys,11,40,-24,-17
2022,128,Liga Profesional Argentina,863426,2022-09-14T19:30:00+00:00,2nd Phase - 19,448,Colon Santa Fe,460,San Lorenzo,0,0,Colon Santa Fe,25,29,San Lorenzo,6,43,-14,-19
2022,128,Liga Profesional Argentina,863427,2022-09-14T22:00:00+00:00,2nd Phase - 19,435,River Plate,449,Banfield,1,2,River Plate,3,47,Banfield,24,30,17,21
2022,128,Liga Profesional Argentina,863428,2022-09-15T00:30:00+00:00,2nd Phase - 19,446,Lanus,451,Boca Juniors,0,1,Lanus,27,21,Boca Juniors,1,52,-31,-26
2022,128,Liga Profesional Argentina,863423,2022-09-15T22:00:00+00:00,2nd Phase - 19,437,Rosario Central,450,Estudiantes L.P.,1,1,Rosario Central,20,32,Estudiantes L.P.,18,33,-1,-2
2022,128,Liga Profesional Argentina,863424,2022-09-15T22:00:00+00:00,2nd Phase - 19,442,Defensa Y Justicia,458,Argentinos JRS,2,1,Defensa Y Justicia,12,40,Argentinos JRS,8,42,-2,-4
2022,128,Liga Profesional Argentina,863432,2022-09-16T00:30:00+00:00,2nd Phase - 19,434,Gimnasia L.P.,459,Arsenal Sarandi,2,0,Gimnasia L.P.,9,41,Arsenal Sarandi,23,30,11,14
2022,128,Liga Profesional Argentina,863425,2022-09-16T00:30:00+00:00,2nd Phase - 19,455,Atletico Tucuman,456,Talleres Cordoba,1,1,Atletico Tucuman,5,46,Talleres Cordoba,13,35,11,8
2022,128,Liga Profesional Argentina,863440,2022-09-17T18:30:00+00:00,2nd Phase - 20,2432,Barracas Central,439,Godoy Cruz,3,1,Barracas Central,17,34,Godoy Cruz,15,35,-1,-2
2022,128,Liga Profesional Argentina,863436,2022-09-17T23:30:00+00:00,2nd Phase - 20,457,Newells Old Boys,474,Sarmiento Junin,0,1,Newells Old Boys,11,40,Sarmiento Junin,21,32,8,10
2022,128,Liga Profesional Argentina,863439,2022-09-18T16:00:00+00:00,2nd Phase - 20,452,Tigre,438,Velez Sarsfield,2,0,Tigre,7,43,Velez Sarsfield,26,28,15,19
2022,128,Liga Profesional Argentina,863443,2022-09-18T18:30:00+00:00,2nd Phase - 20,460,San Lorenzo,435,River Plate,0,1,San Lorenzo,6,43,River Plate,3,47,-4,-3
2022,128,Liga Profesional Argentina,863442,2022-09-18T21:00:00+00:00,2nd Phase - 20,449,Banfield,446,Lanus,1,2,Banfield,24,30,Lanus,27,21,9,3
2022,128,Liga Profesional Argentina,863444,2022-09-18T23:30:00+00:00,2nd Phase - 20,456,Talleres Cordoba,448,Colon Santa Fe,2,0,Talleres Cordoba,13,35,Colon Santa Fe,25,29,6,12
2022,128,Liga Profesional Argentina,863448,2022-09-18T23:30:00+00:00,2nd Phase - 20,1064,Platense,436,Racing Club,0,1,Platense,19,32,Racing Club,2,50,-18,-17
2022,128,Liga Profesional Argentina,863437,2022-09-19T19:30:00+00:00,2nd Phase - 20,459,Arsenal Sarandi,463,Aldosivi,3,0,Arsenal Sarandi,23,30,Aldosivi,28,16,14,5
2022,128,Liga Profesional Argentina,863435,2022-09-19T22:00:00+00:00,2nd Phase - 20,441,Union Santa Fe,453,Independiente,0,1,Union Santa Fe,22,32,Independiente,14,35,-3,-8
2022,128,Liga Profesional Argentina,863441,2022-09-19T22:00:00+00:00,2nd Phase - 20,451,Boca Juniors,445,Huracan,0,0,Boca Juniors,1,52,Huracan,4,47,5,3
2022,128,Liga Profesional Argentina,863446,2022-09-20T00:30:00+00:00,2nd Phase - 20,450,Estudiantes L.P.,442,Defensa Y Justicia,1,2,Estudiantes L.P.,18,33,Defensa Y Justicia,12,40,-7,-6
2022,128,Liga Profesional Argentina,863445,2022-09-20T00:30:00+00:00,2nd Phase - 20,458,Argentinos JRS,455,Atletico Tucuman,1,2,Argentinos JRS,8,42,Atletico Tucuman,5,46,-4,-3
2022,128,Liga Profesional Argentina,863447,2022-09-20T21:00:00+00:00,2nd Phase - 20,444,Patronato,437,Rosario Central,0,0,Patronato,10,40,Rosario Central,20,32,8,10
2022,128,Liga Profesional Argentina,863438,2022-09-20T23:30:00+00:00,2nd Phase - 20,1065,Central Cordoba de Santiago,434,Gimnasia L.P.,1,0,Central Cordoba de Santiago,16,34,Gimnasia L.P.,9,41,-7,-7
2022,128,Liga Profesional Argentina,863457,2022-09-23T22:00:00+00:00,2nd Phase - 21,439,Godoy Cruz,451,Boca Juniors,0,1,Godoy Cruz,15,35,Boca Juniors,1,52,-17,-14
2022,128,Liga Profesional Argentina,863456,2022-09-23T22:00:00+00:00,2nd Phase - 21,445,Huracan,449,Banfield,3,1,Huracan,4,47,Banfield,24,30,17,20
2022,128,Liga Profesional Argentina,863451,2022-09-24T16:00:00+00:00,2nd Phase - 21,442,Defensa Y Justicia,444,Patronato,2,1,Defensa Y Justicia,12,40,Patronato,10,40,0,-2
2022,128,Liga Profesional Argentina,863461,2022-09-24T16:00:00+00:00,2nd Phase - 21,474,Sarmiento Junin,459,Arsenal Sarandi,2,0,Sarmiento Junin,21,32,Arsenal Sarandi,23,30,2,2
2022,128,Liga Profesional Argentina,863455,2022-09-24T18:30:00+00:00,2nd Phase - 21,446,Lanus,460,San Lorenzo,2,0,Lanus,27,21,San Lorenzo,6,43,-22,-21
2022,128,Liga Profesional Argentina,863454,2022-09-24T21:00:00+00:00,2nd Phase - 21,435,River Plate,456,Talleres Cordoba,0,1,River Plate,3,47,Talleres Cordoba,13,35,12,10
2022,128,Liga Profesional Argentina,863462,2022-09-24T23:30:00+00:00,2nd Phase - 21,453,Independiente,457,Newells Old Boys,1,0,Independiente,14,35,Newells Old Boys,11,40,-5,-3
2022,128,Liga Profesional Argentina,863459,2022-09-25T18:30:00+00:00,2nd Phase - 21,434,Gimnasia L.P.,452,Tigre,0,1,Gimnasia L.P.,9,41,Tigre,7,43,-2,-2
2022,128,Liga Profesional Argentina,863450,2022-09-25T18:30:00+00:00,2nd Phase - 21,437,Rosario Central,1064,Platense,1,1,Rosario Central,20,32,Platense,19,32,0,-1
2022,128,Liga Profesional Argentina,863449,2022-09-25T21:00:00+00:00,2nd Phase - 21,436,Racing Club,441,Union Santa Fe,2,1,Racing Club,2,50,Union Santa Fe,22,32,18,20
2022,128,Liga Profesional Argentina,863458,2022-09-25T23:30:00+00:00,2nd Phase - 21,438,Velez Sarsfield,2432,Barracas Central,1,0,Velez Sarsfield,26,28,Barracas Central,17,34,-6,-9
2022,128,Liga Profesional Argentina,863452,2022-09-25T23:30:00+00:00,2nd Phase - 21,455,Atletico Tucuman,450,Estudiantes L.P.,3,1,Atletico Tucuman,5,46,Estudiantes L.P.,18,33,13,13
2022,128,Liga Profesional Argentina,863453,2022-09-26T20:00:00+00:00,2nd Phase - 21,448,Colon Santa Fe,458,Argentinos JRS,0,4,Colon Santa Fe,25,29,Argentinos JRS,8,42,-13,-17
2022,128,Liga Profesional Argentina,863460,2022-09-26T20:00:00+00:00,2nd Phase - 21,463,Aldosivi,1065,Central Cordoba de Santiago,0,3,Aldosivi,28,16,Central Cordoba de Santiago,16,34,-18,-12
2022,128,Liga Profesional Argentina,863467,2022-09-29T18:30:00+00:00,2nd Phase - 22,2432,Barracas Central,434,Gimnasia L.P.,1,1,Barracas Central,17,34,Gimnasia L.P.,9,41,-7,-8
2022,128,Liga Profesional Argentina,863473,2022-09-30T22:00:00+00:00,2nd Phase - 22,450,Estudiantes L.P.,448,Colon Santa Fe,2,4,Estudiantes L.P.,18,33,Colon Santa Fe,25,29,4,7
2022,128,Liga Profesional Argentina,863466,2022-09-30T22:00:00+00:00,2nd Phase - 22,452,Tigre,463,Aldosivi,3,0,Tigre,7,43,Aldosivi,28,16,27,21
2022,128,Liga Profesional Argentina,863476,2022-10-01T00:30:00+00:00,2nd Phase - 22,436,Racing Club,437,Rosario Central,4,3,Racing Club,2,50,Rosario Central,20,32,18,18
2022,128,Liga Profesional Argentina,863463,2022-10-01T00:30:00+00:00,2nd Phase - 22,441,Union Santa Fe,457,Newells Old Boys,0,1,Union Santa Fe,22,32,Newells Old Boys,11,40,-8,-11
2022,128,Liga Profesional Argentina,863475,2022-10-01T16:00:00+00:00,2nd Phase - 22,1064,Platense,442,Defensa Y Justicia,0,0,Platense,19,32,Defensa Y Justicia,12,40,-8,-7
2022,128,Liga Profesional Argentina,863465,2022-10-01T16:00:00+00:00,2nd Phase - 22,1065,Central Cordoba de Santiago,474,Sarmiento Junin,0,0,Central Cordoba de Santiago,16,34,Sarmiento Junin,21,32,2,5
2022,128,Liga Profesional Argentina,863470,2022-10-01T18:30:00+00:00,2nd Phase - 22,460,San Lorenzo,445,Huracan,1,0,San Lorenzo,6,43,Huracan,4,47,-4,-2
2022,128,Liga Profesional Argentina,863469,2022-10-01T21:00:00+00:00,2nd Phase - 22,449,Banfield,439,Godoy Cruz,1,1,Banfield,24,30,Godoy Cruz,15,35,-5,-9
2022,128,Liga Profesional Argentina,863464,2022-10-01T23:30:00+00:00,2nd Phase - 22,459,Arsenal Sarandi,453,Independiente,0,1,Arsenal Sarandi,23,30,Independiente,14,35,-5,-9
2022,128,Liga Profesional Argentina,863474,2022-10-02T18:30:00+00:00,2nd Phase - 22,444,Patronato,455,Atletico Tucuman,2,1,Patronato,10,40,Atletico Tucuman,5,46,-6,-5
2022,128,Liga Profesional Argentina,863468,2022-10-02T21:00:00+00:00,2nd Phase - 22,451,Boca Juniors,438,Velez Sarsfield,1,0,Boca Juniors,1,52,Velez Sarsfield,26,28,24,25
2022,128,Liga Profesional Argentina,863471,2022-10-02T21:30:00+00:00,2nd Phase - 22,456,Talleres Cordoba,446,Lanus,0,1,Talleres Cordoba,13,35,Lanus,27,21,14,14
2022,128,Liga Profesional Argentina,863472,2022-10-02T23:30:00+00:00,2nd Phase - 22,458,Argentinos JRS,435,River Plate,0,3,Argentinos JRS,8,42,River Plate,3,47,-5,-5
2022,128,Liga Profesional Argentina,863477,2022-10-03T23:00:00+00:00,2nd Phase - 23,437,Rosario Central,441,Union Santa Fe,1,1,Rosario Central,20,32,Union Santa Fe,22,32,0,2
2022,128,Liga Profesional Argentina,863487,2022-10-04T17:00:00+00:00,2nd Phase - 23,463,Aldosivi,2432,Barracas Central,2,0,Aldosivi,28,16,Barracas Central,17,34,-18,-11
2022,128,Liga Profesional Argentina,863484,2022-10-04T19:30:00+00:00,2nd Phase - 23,439,Godoy Cruz,460,San Lorenzo,0,0,Godoy Cruz,15,35,San Lorenzo,6,43,-8,-9
2022,128,Liga Profesional Argentina,863490,2022-10-04T19:30:00+00:00,2nd Phase - 23,457,Newells Old Boys,459,Arsenal Sarandi,0,0,Newells Old Boys,11,40,Arsenal Sarandi,23,30,10,12
2022,128,Liga Profesional Argentina,863488,2022-10-04T22:00:00+00:00,2nd Phase - 23,474,Sarmiento Junin,452,Tigre,2,2,Sarmiento Junin,21,32,Tigre,7,43,-11,-14
2022,128,Liga Profesional Argentina,863485,2022-10-05T00:30:00+00:00,2nd Phase - 23,438,Velez Sarsfield,449,Banfield,1,0,Velez Sarsfield,26,28,Banfield,24,30,-2,-2
2022,128,Liga Profesional Argentina,863480,2022-10-05T19:30:00+00:00,2nd Phase - 23,448,Colon Santa Fe,444,Patronato,1,0,Colon Santa Fe,25,29,Patronato,10,40,-11,-15
2022,128,Liga Profesional Argentina,863478,2022-10-05T22:00:00+00:00,2nd Phase - 23,442,Defensa Y Justicia,436,Racing Club,3,3,Defensa Y Justicia,12,40,Racing Club,2,50,-10,-10
2022,128,Liga Profesional Argentina,863479,2022-10-05T22:00:00+00:00,2nd Phase - 23,455,Atletico Tucuman,1064,Platense,2,1,Atletico Tucuman,5,46,Platense,19,32,14,14
2022,128,Liga Profesional Argentina,863481,2022-10-06T00:30:00+00:00,2nd Phase - 23,435,River Plate,450,Estudiantes L.P.,5,0,River Plate,3,47,Estudiantes L.P.,18,33,14,15
2022,128,Liga Profesional Argentina,863489,2022-10-06T00:30:00+00:00,2nd Phase - 23,453,Independiente,1065,Central Cordoba de Santiago,1,2,Independiente,14,35,Central Cordoba de Santiago,16,34,1,2
2022,128,Liga Profesional Argentina,863483,2022-10-06T22:00:00+00:00,2nd Phase - 23,445,Huracan,456,Talleres Cordoba,1,0,Huracan,4,47,Talleres Cordoba,13,35,12,9
2022,128,Liga Profesional Argentina,863482,2022-10-06T22:00:00+00:00,2nd Phase - 23,446,Lanus,458,Argentinos JRS,0,4,Lanus,27,21,Argentinos JRS,8,42,-21,-19
2022,128,Liga Profesional Argentina,863494,2022-10-08T16:00:00+00:00,2nd Phase - 24,2432,Barracas Central,474,Sarmiento Junin,1,1,Barracas Central,17,34,Sarmiento Junin,21,32,2,4
2022,128,Liga Profesional Argentina,863497,2022-10-08T19:00:00+00:00,2nd Phase - 24,460,San Lorenzo,438,Velez Sarsfield,1,0,San Lorenzo,6,43,Velez Sarsfield,26,28,15,20
2022,128,Liga Profesional Argentina,863491,2022-10-08T21:15:00+00:00,2nd Phase - 24,441,Union Santa Fe,459,Arsenal Sarandi,1,0,Union Santa Fe,22,32,Arsenal Sarandi,23,30,2,1
2022,128,Liga Profesional Argentina,863502,2022-10-08T23:30:00+00:00,2nd Phase - 24,1064,Platense,448,Colon Santa Fe,1,2,Platense,19,32,Colon Santa Fe,25,29,3,6
2022,128,Liga Profesional Argentina,863493,2022-10-09T16:00:00+00:00,2nd Phase - 24,452,Tigre,453,Independiente,2,1,Tigre,7,43,Independiente,14,35,8,7
2022,128,Liga Profesional Argentina,863496,2022-10-09T18:30:00+00:00,2nd Phase - 24,449,Banfield,434,Gimnasia L.P.,0,2,Banfield,24,30,Gimnasia L.P.,9,41,-11,-15
2022,128,Liga Profesional Argentina,863498,2022-10-09T18:30:00+00:00,2nd Phase - 24,456,Talleres Cordoba,439,Godoy Cruz,3,1,Talleres Cordoba,13,35,Godoy Cruz,15,35,0,2
2022,128,Liga Profesional Argentina,863495,2022-10-09T21:00:00+00:00,2nd Phase - 24,451,Boca Juniors,463,Aldosivi,2,1,Boca Juniors,1,52,Aldosivi,28,16,36,27
2022,128,Liga Profesional Argentina,863501,2022-10-09T23:30:00+00:00,2nd Phase - 24,444,Patronato,435,River Plate,0,1,Patronato,10,40,River Plate,3,47,-7,-7
2022,128,Liga Profesional Argentina,863504,2022-10-10T19:30:00+00:00,2nd Phase - 24,437,Rosario Central,442,Defensa Y Justicia,0,0,Rosario Central,20,32,Defensa Y Justicia,12,40,-8,-8
2022,128,Liga Profesional Argentina,863499,2022-10-10T19:30:00+00:00,2nd Phase - 24,458,Argentinos JRS,445,Huracan,1,1,Argentinos JRS,8,42,Huracan,4,47,-5,-4
2022,128,Liga Profesional Argentina,863503,2022-10-10T22:00:00+00:00,2nd Phase - 24,436,Racing Club,455,Atletico Tucuman,2,0,Racing Club,2,50,Atletico Tucuman,5,46,4,3
2022,128,Liga Profesional Argentina,863500,2022-10-10T22:00:00+00:00,2nd Phase - 24,450,Estudiantes L.P.,446,Lanus,3,1,Estudiantes L.P.,18,33,Lanus,27,21,12,9
2022,128,Liga Profesional Argentina,863492,2022-10-11T00:30:00+00:00,2nd Phase - 24,1065,Central Cordoba de Santiago,457,Newells Old Boys,0,3,Central Cordoba de Santiago,16,34,Newells Old Boys,11,40,-6,-5
2022,128,Liga Profesional Argentina,863514,2022-10-12T17:00:00+00:00,2nd Phase - 25,463,Aldosivi,449,Banfield,0,1,Aldosivi,28,16,Banfield,24,30,-14,-4
2022,128,Liga Profesional Argentina,863513,2022-10-12T19:30:00+00:00,2nd Phase - 25,434,Gimnasia L.P.,460,San Lorenzo,0,1,Gimnasia L.P.,9,41,San Lorenzo,6,43,-2,-3
2022,128,Liga Profesional Argentina,863515,2022-10-12T19:30:00+00:00,2nd Phase - 25,474,Sarmiento Junin,451,Boca Juniors,0,1,Sarmiento Junin,21,32,Boca Juniors,1,52,-20,-20
2022,128,Liga Profesional Argentina,863516,2022-10-12T22:00:00+00:00,2nd Phase - 25,453,Independiente,2432,Barracas Central,2,2,Independiente,14,35,Barracas Central,17,34,1,3
2022,128,Liga Profesional Argentina,863508,2022-10-13T00:30:00+00:00,2nd Phase - 25,435,River Plate,1064,Platense,2,1,River Plate,3,47,Platense,19,32,15,16
2022,128,Liga Profesional Argentina,863512,2022-10-13T19:30:00+00:00,2nd Phase - 25,438,Velez Sarsfield,456,Talleres Cordoba,2,1,Velez Sarsfield,26,28,Talleres Cordoba,13,35,-7,-13
2022,128,Liga Profesional Argentina,863511,2022-10-13T22:00:00+00:00,2nd Phase - 25,439,Godoy Cruz,458,Argentinos JRS,0,0,Godoy Cruz,15,35,Argentinos JRS,8,42,-7,-7
2022,128,Liga Profesional Argentina,863509,2022-10-13T22:00:00+00:00,2nd Phase - 25,446,Lanus,444,Patronato,0,1,Lanus,27,21,Patronato,10,40,-19,-17
2022,128,Liga Profesional Argentina,863506,2022-10-14T00:30:00+00:00,2nd Phase - 25,455,Atletico Tucuman,437,Rosario Central,1,1,Atletico Tucuman,5,46,Rosario Central,20,32,14,15
2022,128,Liga Profesional Argentina,863517,2022-10-14T00:30:00+00:00,2nd Phase - 25,457,Newells Old Boys,452,Tigre,0,2,Newells Old Boys,11,40,Tigre,7,43,-3,-4
2022,128,Liga Profesional Argentina,863507,2022-10-14T19:30:00+00:00,2nd Phase - 25,448,Colon Santa Fe,436,Racing Club,0,2,Colon Santa Fe,25,29,Racing Club,2,50,-21,-23
2022,128,Liga Profesional Argentina,863505,2022-10-14T22:00:00+00:00,2nd Phase - 25,442,Defensa Y Justicia,441,Union Santa Fe,1,0,Defensa Y Justicia,12,40,Union Santa Fe,22,32,8,10
2022,128,Liga Profesional Argentina,863510,2022-10-14T22:00:00+00:00,2nd Phase - 25,445,Huracan,450,Estudiantes L.P.,3,1,Huracan,4,47,Estudiantes L.P.,18,33,14,14
2022,128,Liga Profesional Argentina,863518,2022-10-15T00:30:00+00:00,2nd Phase - 25,459,Arsenal Sarandi,1065,Central Cordoba de Santiago,2,0,Arsenal Sarandi,23,30,Central Cordoba de Santiago,16,34,-4,-7
2022,128,Liga Profesional Argentina,863527,2022-10-16T16:00:00+00:00,2nd Phase - 26,463,Aldosivi,456,Talleres Cordoba,1,3,Aldosivi,28,16,Talleres Cordoba,13,35,-19,-15
2022,128,Liga Profesional Argentina,863530,2022-10-16T18:30:00+00:00,2nd Phase - 26,457,Newells Old Boys,451,Boca Juniors,2,0,Newells Old Boys,11,40,Boca Juniors,1,52,-12,-10
2022,128,Liga Profesional Argentina,863524,2022-10-16T21:00:00+00:00,2nd Phase - 26,439,Godoy Cruz,444,Patronato,0,1,Godoy Cruz,15,35,Patronato,10,40,-5,-5
2022,128,Liga Profesional Argentina,863529,2022-10-16T21:00:00+00:00,2nd Phase - 26,453,Independiente,449,Banfield,1,0,Independiente,14,35,Banfield,24,30,5,10
2022,128,Liga Profesional Argentina,863521,2022-10-16T23:30:00+00:00,2nd Phase - 26,435,River Plate,437,Rosario Central,1,2,River Plate,3,47,Rosario Central,20,32,15,17
2022,128,Liga Profesional Argentina,863531,2022-10-17T17:00:00+00:00,2nd Phase - 26,459,Arsenal Sarandi,2432,Barracas Central,1,2,Arsenal Sarandi,23,30,Barracas Central,17,34,-4,-6
2022,128,Liga Profesional Argentina,863526,2022-10-17T18:00:00+00:00,2nd Phase - 26,434,Gimnasia L.P.,458,Argentinos JRS,0,0,Gimnasia L.P.,9,41,Argentinos JRS,8,42,-1,-1
2022,128,Liga Profesional Argentina,863525,2022-10-17T19:30:00+00:00,2nd Phase - 26,438,Velez Sarsfield,450,Estudiantes L.P.,4,0,Velez Sarsfield,26,28,Estudiantes L.P.,18,33,-5,-8
2022,128,Liga Profesional Argentina,863519,2022-10-18T00:30:00+00:00,2nd Phase - 26,455,Atletico Tucuman,441,Union Santa Fe,1,1,Atletico Tucuman,5,46,Union Santa Fe,22,32,14,17
2022,128,Liga Profesional Argentina,863528,2022-10-18T00:30:00+00:00,2nd Phase - 26,474,Sarmiento Junin,460,San Lorenzo,2,4,Sarmiento Junin,21,32,San Lorenzo,6,43,-11,-15
2022,128,Liga Profesional Argentina,863520,2022-10-18T19:30:00+00:00,2nd Phase - 26,448,Colon Santa Fe,442,Defensa Y Justicia,1,2,Colon Santa Fe,25,29,Defensa Y Justicia,12,40,-11,-13
2022,128,Liga Profesional Argentina,863522,2022-10-18T22:00:00+00:00,2nd Phase - 26,446,Lanus,436,Racing Club,0,1,Lanus,27,21,Racing Club,2,50,-29,-25
2022,128,Liga Profesional Argentina,863523,2022-10-19T00:30:00+00:00,2nd Phase - 26,445,Huracan,1064,Platense,2,0,Huracan,4,47,Platense,19,32,15,15
2022,128,Liga Profesional Argentina,863532,2022-10-19T00:30:00+00:00,2nd Phase - 26,1065,Central Cordoba de Santiago,452,Tigre,1,2,Central Cordoba de Santiago,16,34,Tigre,7,43,-9,-9
2022,128,Liga Profesional Argentina,863309,2022-10-20T00:30:00+00:00,2nd Phase - 11,456,Talleres Cordoba,441,Union Santa Fe,2,2,Talleres Cordoba,13,35,Union Santa Fe,22,32,3,9
2022,128,Liga Profesional Argentina,863486,2022-10-20T20:00:00+00:00,2nd Phase - 23,434,Gimnasia L.P.,451,Boca Juniors,1,2,Gimnasia L.P.,9,41,Boca Juniors,1,52,-11,-8
2022,128,Liga Profesional Argentina,863533,2022-10-22T17:00:00+00:00,2nd Phase - 27,441,Union Santa Fe,1065,Central Cordoba de Santiago,1,4,Union Santa Fe,22,32,Central Cordoba de Santiago,16,34,-2,-6
2022,128,Liga Profesional Argentina,863546,2022-10-22T19:30:00+00:00,2nd Phase - 27,442,Defensa Y Justicia,455,Atletico Tucuman,3,1,Defensa Y Justicia,12,40,Atletico Tucuman,5,46,-6,-7
2022,128,Liga Profesional Argentina,863541,2022-10-22T19:30:00+00:00,2nd Phase - 27,450,Estudiantes L.P.,439,Godoy Cruz,2,0,Estudiantes L.P.,18,33,Godoy Cruz,15,35,-2,-3
2022,128,Liga Profesional Argentina,863538,2022-10-22T19:30:00+00:00,2nd Phase - 27,460,San Lorenzo,463,Aldosivi,3,0,San Lorenzo,6,43,Aldosivi,28,16,27,22
2022,128,Liga Profesional Argentina,863540,2022-10-22T22:30:00+00:00,2nd Phase - 27,458,Argentinos JRS,438,Velez Sarsfield,2,0,Argentinos JRS,8,42,Velez Sarsfield,26,28,14,18
2022,128,Liga Profesional Argentina,863537,2022-10-23T15:00:00+00:00,2nd Phase - 27,449,Banfield,474,Sarmiento Junin,0,0,Banfield,24,30,Sarmiento Junin,21,32,-2,-3
2022,128,Liga Profesional Argentina,863539,2022-10-23T17:30:00+00:00,2nd Phase - 27,456,Talleres Cordoba,434,Gimnasia L.P.,2,1,Talleres Cordoba,13,35,Gimnasia L.P.,9,41,-6,-4
2022,128,Liga Profesional Argentina,863544,2022-10-23T20:00:00+00:00,2nd Phase - 27,436,Racing Club,435,River Plate,1,2,Racing Club,2,50,River Plate,3,47,3,1
2022,128,Liga Profesional Argentina,863542,2022-10-23T20:00:00+00:00,2nd Phase - 27,444,Patronato,445,Huracan,3,2,Patronato,10,40,Huracan,4,47,-7,-6
2022,128,Liga Profesional Argentina,863536,2022-10-23T20:00:00+00:00,2nd Phase - 27,451,Boca Juniors,453,Independiente,2,2,Boca Juniors,1,52,Independiente,14,35,17,13
2022,128,Liga Profesional Argentina,863535,2022-10-24T18:30:00+00:00,2nd Phase - 27,2432,Barracas Central,457,Newells Old Boys,1,1,Barracas Central,17,34,Newells Old Boys,11,40,-6,-6
2022,128,Liga Profesional Argentina,863545,2022-10-24T19:30:00+00:00,2nd Phase - 27,437,Rosario Central,448,Colon Santa Fe,1,1,Rosario Central,20,32,Colon Santa Fe,25,29,3,5
2022,128,Liga Profesional Argentina,863534,2022-10-24T23:30:00+00:00,2nd Phase - 27,452,Tigre,459,Arsenal Sarandi,1,4,Tigre,7,43,Arsenal Sarandi,23,30,13,16
2022,128,Liga Profesional Argentina,863431,2022-10-25T22:00:00+00:00,2nd Phase - 19,438,Velez Sarsfield,1065,Central Cordoba de Santiago,3,1,Velez Sarsfield,26,28,Central Cordoba de Santiago,16,34,-6,-10
2022,128,Liga Profesional Argentina,863543,2022-10-25T23:00:00+00:00,2nd Phase - 27,1064,Platense,446,Lanus,1,1,Platense,19,32,Lanus,27,21,11,8
2023,128,Liga Profesional Argentina,971352,2023-01-26T22:15:00+00:00,Round - 1,437,Rosario Central,458,Argentinos JRS,1,0,Rosario Central,8,42,Argentinos JRS,10,40,2,2
2023,128,Liga Profesional Argentina,971353,2023-01-27T22:15:00+00:00,Round - 1,450,Estudiantes L.P.,452,Tigre,1,2,Estudiantes L.P.,5,45,Tigre,16,34,11,11
2023,128,Liga Profesional Argentina,971361,2023-01-27T22:15:00+00:00,Round - 1,456,Talleres Cordoba,453,Independiente,0,1,Talleres Cordoba,2,50,Independiente,24,28,22,22
2023,128,Liga Profesional Argentina,971358,2023-01-28T00:30:00+00:00,Round - 1,442,Defensa Y Justicia,445,Huracan,2,4,Defensa Y Justicia,6,44,Huracan,26,25,19,20
2023,128,Liga Profesional Argentina,971354,2023-01-28T20:00:00+00:00,Round - 1,460,San Lorenzo,459,Arsenal Sarandi,1,0,San Lorenzo,3,46,Arsenal Sarandi,28,22,24,25
2023,128,Liga Profesional Argentina,971351,2023-01-28T22:15:00+00:00,Round - 1,436,Racing Club,440,Belgrano Cordoba,0,0,Racing Club,12,36,Belgrano Cordoba,13,36,0,1
2023,128,Liga Profesional Argentina,971355,2023-01-28T22:15:00+00:00,Round - 1,448,Colon Santa Fe,446,Lanus,1,2,Colon Santa Fe,27,25,Lanus,4,45,-20,-23
2023,128,Liga Profesional Argentina,988697,2023-01-28T22:15:00+00:00,Round - 1,478,Instituto Cordoba,474,Sarmiento Junin,0,0,Instituto Cordoba,18,32,Sarmiento Junin,19,30,2,1
2023,128,Liga Profesional Argentina,971350,2023-01-29T00:30:00+00:00,Round - 1,1065,Central Cordoba de Santiago,435,River Plate,0,2,Central Cordoba de Santiago,23,29,River Plate,1,61,-32,-22
2023,128,Liga Profesional Argentina,971360,2023-01-29T20:00:00+00:00,Round - 1,1064,Platense,457,Newells Old Boys,2,2,Platense,17,34,Newells Old Boys,14,35,-1,-3
2023,128,Liga Profesional Argentina,971362,2023-01-30T00:30:00+00:00,Round - 1,451,Boca Juniors,455,Atletico Tucuman,1,0,Boca Juniors,7,44,Atletico Tucuman,11,37,7,4
2023,128,Liga Profesional Argentina,971356,2023-01-30T20:00:00+00:00,Round - 1,2432,Barracas Central,439,Godoy Cruz,0,1,Barracas Central,15,35,Godoy Cruz,9,41,-6,-6
2023,128,Liga Profesional Argentina,971359,2023-01-30T23:00:00+00:00,Round - 1,438,Velez Sarsfield,434,Gimnasia L.P.,3,1,Velez Sarsfield,25,27,Gimnasia L.P.,22,30,-3,-3
2023,128,Liga Profesional Argentina,971357,2023-01-30T23:00:00+00:00,Round - 1,449,Banfield,441,Union Santa Fe,0,0,Banfield,21,30,Union Santa Fe,20,30,0,-1
2023,128,Liga Profesional Argentina,971372,2023-02-03T23:00:00+00:00,Round - 2,452,Tigre,437,Rosario Central,2,2,Tigre,16,34,Rosario Central,8,42,-8,-8
2023,128,Liga Profesional Argentina,971366,2023-02-03T23:00:00+00:00,Round - 2,457,Newells Old Boys,438,Velez Sarsfield,1,0,Newells Old Boys,14,35,Velez Sarsfield,25,27,8,11
2023,128,Liga Profesional Argentina,971371,2023-02-04T20:00:00+00:00,Round - 2,459,Arsenal Sarandi,450,Estudiantes L.P.,1,1,Arsenal Sarandi,28,22,Estudiantes L.P.,5,45,-23,-23
2023,128,Liga Profesional Argentina,988698,2023-02-04T20:00:00+00:00,Round - 2,474,Sarmiento Junin,2432,Barracas Central,3,5,Sarmiento Junin,19,30,Barracas Central,15,35,-5,-4
2023,128,Liga Profesional Argentina,971374,2023-02-04T22:15:00+00:00,Round - 2,440,Belgrano Cordoba,435,River Plate,2,1,Belgrano Cordoba,13,36,River Plate,1,61,-25,-12
2023,128,Liga Profesional Argentina,971370,2023-02-05T00:30:00+00:00,Round - 2,446,Lanus,460,San Lorenzo,2,1,Lanus,4,45,San Lorenzo,3,46,-1,-1
2023,128,Liga Profesional Argentina,971373,2023-02-05T00:30:00+00:00,Round - 2,458,Argentinos JRS,436,Racing Club,1,0,Argentinos JRS,10,40,Racing Club,12,36,4,2
2023,128,Liga Profesional Argentina,971365,2023-02-05T20:00:00+00:00,Round - 2,453,Independiente,1064,Platense,1,2,Independiente,24,28,Platense,17,34,-6,-7
2023,128,Liga Profesional Argentina,971363,2023-02-05T22:15:00+00:00,Round - 2,451,Boca Juniors,1065,Central Cordoba de Santiago,0,0,Boca Juniors,7,44,Central Cordoba de Santiago,23,29,15,16
2023,128,Liga Profesional Argentina,971369,2023-02-06T00:30:00+00:00,Round - 2,439,Godoy Cruz,448,Colon Santa Fe,1,0,Godoy Cruz,9,41,Colon Santa Fe,27,25,16,18
2023,128,Liga Profesional Argentina,988699,2023-02-06T00:30:00+00:00,Round - 2,441,Union Santa Fe,478,Instituto Cordoba,0,2,Union Santa Fe,20,30,Instituto Cordoba,18,32,-2,-2
2023,128,Liga Profesional Argentina,971364,2023-02-06T00:30:00+00:00,Round - 2,455,Atletico Tucuman,456,Talleres Cordoba,0,2,Atletico Tucuman,11,37,Talleres Cordoba,2,50,-13,-9
2023,128,Liga Profesional Argentina,971367,2023-02-06T21:00:00+00:00,Round - 2,434,Gimnasia L.P.,442,Defensa Y Justicia,0,2,Gimnasia L.P.,22,30,Defensa Y Justicia,6,44,-14,-16
2023,128,Liga Profesional Argentina,971368,2023-02-07T00:30:00+00:00,Round - 2,445,Huracan,449,Banfield,3,2,Huracan,26,25,Banfield,21,30,-5,-5
2023,128,Liga Profesional Argentina,988700,2023-02-11T00:30:00+00:00,Round - 3,448,Colon Santa Fe,474,Sarmiento Junin,0,2,Colon Santa Fe,27,25,Sarmiento Junin,19,30,-5,-8
2023,128,Liga Profesional Argentina,971375,2023-02-11T00:30:00+00:00,Round - 3,1065,Central Cordoba de Santiago,440,Belgrano Cordoba,0,1,Central Cordoba de Santiago,23,29,Belgrano Cordoba,13,36,-7,-10
2023,128,Liga Profesional Argentina,971383,2023-02-11T20:00:00+00:00,Round - 3,442,Defensa Y Justicia,457,Newells Old Boys,1,0,Defensa Y Justicia,6,44,Newells Old Boys,14,35,9,8
2023,128,Liga Profesional Argentina,971380,2023-02-11T20:00:00+00:00,Round - 3,460,San Lorenzo,439,Godoy Cruz,1,0,San Lorenzo,3,46,Godoy Cruz,9,41,5,6
2023,128,Liga Profesional Argentina,971385,2023-02-11T22:15:00+00:00,Round - 3,1064,Platense,455,Atletico Tucuman,1,1,Platense,17,34,Atletico Tucuman,11,37,-3,-6
2023,128,Liga Profesional Argentina,971384,2023-02-12T00:30:00+00:00,Round - 3,438,Velez Sarsfield,453,Independiente,0,0,Velez Sarsfield,25,27,Independiente,24,28,-1,-1
2023,128,Liga Profesional Argentina,971386,2023-02-12T00:30:00+00:00,Round - 3,456,Talleres Cordoba,451,Boca Juniors,2,1,Talleres Cordoba,2,50,Boca Juniors,7,44,6,5
2023,128,Liga Profesional Argentina,971378,2023-02-12T20:00:00+00:00,Round - 3,437,Rosario Central,459,Arsenal Sarandi,2,1,Rosario Central,8,42,Arsenal Sarandi,28,22,20,20
2023,128,Liga Profesional Argentina,971382,2023-02-12T20:00:00+00:00,Round - 3,449,Banfield,434,Gimnasia L.P.,0,0,Banfield,21,30,Gimnasia L.P.,22,30,0,1
2023,128,Liga Profesional Argentina,971376,2023-02-12T22:15:00+00:00,Round - 3,435,River Plate,458,Argentinos JRS,2,1,River Plate,1,61,Argentinos JRS,10,40,21,9
2023,128,Liga Profesional Argentina,971377,2023-02-13T00:30:00+00:00,Round - 3,436,Racing Club,452,Tigre,2,2,Racing Club,12,36,Tigre,16,34,2,4
2023,128,Liga Profesional Argentina,988701,2023-02-13T00:30:00+00:00,Round - 3,478,Instituto Cordoba,445,Huracan,0,0,Instituto Cordoba,18,32,Huracan,26,25,7,8
2023,128,Liga Profesional Argentina,971381,2023-02-13T20:00:00+00:00,Round - 3,2432,Barracas Central,441,Union Santa Fe,1,1,Barracas Central,15,35,Union Santa Fe,20,30,5,5
2023,128,Liga Profesional Argentina,971379,2023-02-13T23:00:00+00:00,Round - 3,450,Estudiantes L.P.,446,Lanus,0,2,Estudiantes L.P.,5,45,Lanus,4,45,0,-1
2023,128,Liga Profesional Argentina,988702,2023-02-17T21:00:00+00:00,Round - 4,434,Gimnasia L.P.,478,Instituto Cordoba,2,0,Gimnasia L.P.,22,30,Instituto Cordoba,18,32,-2,-4
2023,128,Liga Profesional Argentina,971392,2023-02-18T00:30:00+00:00,Round - 4,445,Huracan,2432,Barracas Central,2,0,Huracan,26,25,Barracas Central,15,35,-10,-11
2023,128,Liga Profesional Argentina,971396,2023-02-18T00:30:00+00:00,Round - 4,459,Arsenal Sarandi,436,Racing Club,0,3,Arsenal Sarandi,28,22,Racing Club,12,36,-14,-16
2023,128,Liga Profesional Argentina,971395,2023-02-18T20:00:00+00:00,Round - 4,446,Lanus,437,Rosario Central,3,0,Lanus,4,45,Rosario Central,8,42,3,4
2023,128,Liga Profesional Argentina,971397,2023-02-18T21:00:00+00:00,Round - 4,452,Tigre,435,River Plate,0,1,Tigre,16,34,River Plate,1,61,-27,-15
2023,128,Liga Profesional Argentina,971394,2023-02-18T22:15:00+00:00,Round - 4,439,Godoy Cruz,450,Estudiantes L.P.,0,1,Godoy Cruz,9,41,Estudiantes L.P.,5,45,-4,-4
2023,128,Liga Profesional Argentina,971398,2023-02-18T22:15:00+00:00,Round - 4,458,Argentinos JRS,440,Belgrano Cordoba,3,0,Argentinos JRS,10,40,Belgrano Cordoba,13,36,4,3
2023,128,Liga Profesional Argentina,971391,2023-02-19T00:00:00+00:00,Round - 4,457,Newells Old Boys,449,Banfield,2,0,Newells Old Boys,14,35,Banfield,21,30,5,7
2023,128,Liga Profesional Argentina,971393,2023-02-19T20:00:00+00:00,Round - 4,441,Union Santa Fe,448,Colon Santa Fe,1,1,Union Santa Fe,20,30,Colon Santa Fe,27,25,5,7
2023,128,Liga Profesional Argentina,971388,2023-02-19T22:15:00+00:00,Round - 4,451,Boca Juniors,1064,Platense,3,1,Boca Juniors,7,44,Platense,17,34,10,10
2023,128,Liga Profesional Argentina,971390,2023-02-20T00:30:00+00:00,Round - 4,453,Independiente,442,Defensa Y Justicia,0,2,Independiente,24,28,Defensa Y Justicia,6,44,-16,-18
2023,128,Liga Profesional Argentina,971387,2023-02-20T00:30:00+00:00,Round - 4,456,Talleres Cordoba,1065,Central Cordoba de Santiago,2,0,Talleres Cordoba,2,50,Central Cordoba de Santiago,23,29,21,21
2023,128,Liga Profesional Argentina,988703,2023-02-20T22:15:00+00:00,Round - 4,474,Sarmiento Junin,460,San Lorenzo,0,1,Sarmiento Junin,19,30,San Lorenzo,3,46,-16,-16
2023,128,Liga Profesional Argentina,971389,2023-02-21T00:30:00+00:00,Round - 4,455,Atletico Tucuman,438,Velez Sarsfield,1,1,Atletico Tucuman,11,37,Velez Sarsfield,25,27,10,14
2023,128,Liga Profesional Argentina,971403,2023-02-25T00:00:00+00:00,Round - 5,437,Rosario Central,439,Godoy Cruz,1,0,Rosario Central,8,42,Godoy Cruz,9,41,1,1
2023,128,Liga Profesional Argentina,971400,2023-02-25T00:00:00+00:00,Round - 5,440,Belgrano Cordoba,452,Tigre,0,2,Belgrano Cordoba,13,36,Tigre,16,34,2,3
2023,128,Liga Profesional Argentina,971404,2023-02-25T20:00:00+00:00,Round - 5,460,San Lorenzo,441,Union Santa Fe,1,0,San Lorenzo,3,46,Union Santa Fe,20,30,16,17
2023,128,Liga Profesional Argentina,988704,2023-02-25T22:15:00+00:00,Round - 5,450,Estudiantes L.P.,474,Sarmiento Junin,1,1,Estudiantes L.P.,5,45,Sarmiento Junin,19,30,15,14
2023,128,Liga Profesional Argentina,971410,2023-02-25T22:15:00+00:00,Round - 5,1064,Platense,456,Talleres Cordoba,2,4,Platense,17,34,Talleres Cordoba,2,50,-16,-15
2023,128,Liga Profesional Argentina,971409,2023-02-26T00:30:00+00:00,Round - 5,438,Velez Sarsfield,451,Boca Juniors,1,2,Velez Sarsfield,25,27,Boca Juniors,7,44,-17,-18
2023,128,Liga Profesional Argentina,971408,2023-02-26T20:00:00+00:00,Round - 5,442,Defensa Y Justicia,455,Atletico Tucuman,3,0,Defensa Y Justicia,6,44,Atletico Tucuman,11,37,7,5
2023,128,Liga Profesional Argentina,971405,2023-02-26T20:00:00+00:00,Round - 5,448,Colon Santa Fe,445,Huracan,1,1,Colon Santa Fe,27,25,Huracan,26,25,0,-1
2023,128,Liga Profesional Argentina,971401,2023-02-26T22:15:00+00:00,Round - 5,435,River Plate,459,Arsenal Sarandi,1,2,River Plate,1,61,Arsenal Sarandi,28,22,39,27
2023,128,Liga Profesional Argentina,971407,2023-02-27T00:30:00+00:00,Round - 5,449,Banfield,453,Independiente,0,0,Banfield,21,30,Independiente,24,28,2,3
2023,128,Liga Profesional Argentina,988705,2023-02-27T00:30:00+00:00,Round - 5,478,Instituto Cordoba,457,Newells Old Boys,3,1,Instituto Cordoba,18,32,Newells Old Boys,14,35,-3,-4
2023,128,Liga Profesional Argentina,971406,2023-02-27T20:00:00+00:00,Round - 5,2432,Barracas Central,434,Gimnasia L.P.,1,0,Barracas Central,15,35,Gimnasia L.P.,22,30,5,7
2023,128,Liga Profesional Argentina,971402,2023-02-27T22:15:00+00:00,Round - 5,436,Racing Club,446,Lanus,2,1,Racing Club,12,36,Lanus,4,45,-9,-8
2023,128,Liga Profesional Argentina,971399,2023-02-28T00:30:00+00:00,Round - 5,1065,Central Cordoba de Santiago,458,Argentinos JRS,1,0,Central Cordoba de Santiago,23,29,Argentinos JRS,10,40,-11,-13
2023,128,Liga Profesional Argentina,971418,2023-03-03T23:00:00+00:00,Round - 6,441,Union Santa Fe,450,Estudiantes L.P.,2,0,Union Santa Fe,20,30,Estudiantes L.P.,5,45,-15,-15
2023,128,Liga Profesional Argentina,988707,2023-03-03T23:00:00+00:00,Round - 6,474,Sarmiento Junin,437,Rosario Central,4,1,Sarmiento Junin,19,30,Rosario Central,8,42,-12,-11
2023,128,Liga Profesional Argentina,971416,2023-03-04T20:00:00+00:00,Round - 6,434,Gimnasia L.P.,448,Colon Santa Fe,0,0,Gimnasia L.P.,22,30,Colon Santa Fe,27,25,5,5
2023,128,Liga Profesional Argentina,971411,2023-03-04T20:00:00+00:00,Round - 6,1064,Platense,1065,Central Cordoba de Santiago,1,1,Platense,17,34,Central Cordoba de Santiago,23,29,5,6
2023,128,Liga Profesional Argentina,971420,2023-03-04T22:15:00+00:00,Round - 6,446,Lanus,435,River Plate,0,2,Lanus,4,45,River Plate,1,61,-16,-3
2023,128,Liga Profesional Argentina,971414,2023-03-05T00:30:00+00:00,Round - 6,455,Atletico Tucuman,449,Banfield,1,0,Atletico Tucuman,11,37,Banfield,21,30,7,10
2023,128,Liga Profesional Argentina,971415,2023-03-05T00:30:00+00:00,Round - 6,457,Newells Old Boys,2432,Barracas Central,1,0,Newells Old Boys,14,35,Barracas Central,15,35,0,1
2023,128,Liga Profesional Argentina,988706,2023-03-05T20:00:00+00:00,Round - 6,453,Independiente,478,Instituto Cordoba,2,2,Independiente,24,28,Instituto Cordoba,18,32,-4,-6
2023,128,Liga Profesional Argentina,971417,2023-03-05T22:15:00+00:00,Round - 6,445,Huracan,460,San Lorenzo,1,1,Huracan,26,25,San Lorenzo,3,46,-21,-23
2023,128,Liga Profesional Argentina,971422,2023-03-06T00:30:00+00:00,Round - 6,452,Tigre,458,Argentinos JRS,0,1,Tigre,16,34,Argentinos JRS,10,40,-6,-6
2023,128,Liga Profesional Argentina,971412,2023-03-06T00:30:00+00:00,Round - 6,456,Talleres Cordoba,438,Velez Sarsfield,1,2,Talleres Cordoba,2,50,Velez Sarsfield,25,27,23,23
2023,128,Liga Profesional Argentina,971419,2023-03-06T20:00:00+00:00,Round - 6,439,Godoy Cruz,436,Racing Club,2,0,Godoy Cruz,9,41,Racing Club,12,36,5,3
2023,128,Liga Profesional Argentina,971421,2023-03-06T20:00:00+00:00,Round - 6,459,Arsenal Sarandi,440,Belgrano Cordoba,0,1,Arsenal Sarandi,28,22,Belgrano Cordoba,13,36,-14,-15
2023,128,Liga Profesional Argentina,971413,2023-03-07T00:00:00+00:00,Round - 6,451,Boca Juniors,442,Defensa Y Justicia,0,0,Boca Juniors,7,44,Defensa Y Justicia,6,44,0,-1
2023,128,Liga Profesional Argentina,971431,2023-03-10T20:00:00+00:00,Round - 7,2432,Barracas Central,453,Independiente,1,1,Barracas Central,15,35,Independiente,24,28,7,9
2023,128,Liga Profesional Argentina,971424,2023-03-11T00:00:00+00:00,Round - 7,458,Argentinos JRS,459,Arsenal Sarandi,1,1,Argentinos JRS,10,40,Arsenal Sarandi,28,22,18,18
2023,128,Liga Profesional Argentina,988709,2023-03-11T00:00:00+00:00,Round - 7,478,Instituto Cordoba,455,Atletico Tucuman,1,1,Instituto Cordoba,18,32,Atletico Tucuman,11,37,-5,-7
2023,128,Liga Profesional Argentina,971429,2023-03-11T20:00:00+00:00,Round - 7,460,San Lorenzo,434,Gimnasia L.P.,4,0,San Lorenzo,3,46,Gimnasia L.P.,22,30,16,19
2023,128,Liga Profesional Argentina,971433,2023-03-11T22:15:00+00:00,Round - 7,442,Defensa Y Justicia,456,Talleres Cordoba,1,1,Defensa Y Justicia,6,44,Talleres Cordoba,2,50,-6,-4
2023,128,Liga Profesional Argentina,971425,2023-03-12T00:30:00+00:00,Round - 7,440,Belgrano Cordoba,446,Lanus,0,0,Belgrano Cordoba,13,36,Lanus,4,45,-9,-9
2023,128,Liga Profesional Argentina,971423,2023-03-12T00:30:00+00:00,Round - 7,1065,Central Cordoba de Santiago,452,Tigre,2,0,Central Cordoba de Santiago,23,29,Tigre,16,34,-5,-7
2023,128,Liga Profesional Argentina,988708,2023-03-12T20:00:00+00:00,Round - 7,436,Racing Club,474,Sarmiento Junin,1,0,Racing Club,12,36,Sarmiento Junin,19,30,6,7
2023,128,Liga Profesional Argentina,971426,2023-03-12T22:15:00+00:00,Round - 7,435,River Plate,439,Godoy Cruz,3,0,River Plate,1,61,Godoy Cruz,9,41,20,8
2023,128,Liga Profesional Argentina,971428,2023-03-12T22:15:00+00:00,Round - 7,450,Estudiantes L.P.,445,Huracan,2,1,Estudiantes L.P.,5,45,Huracan,26,25,20,21
2023,128,Liga Profesional Argentina,971427,2023-03-13T00:30:00+00:00,Round - 7,437,Rosario Central,441,Union Santa Fe,1,1,Rosario Central,8,42,Union Santa Fe,20,30,12,12
2023,128,Liga Profesional Argentina,971432,2023-03-13T00:30:00+00:00,Round - 7,449,Banfield,451,Boca Juniors,1,0,Banfield,21,30,Boca Juniors,7,44,-14,-14
2023,128,Liga Profesional Argentina,971434,2023-03-14T00:00:00+00:00,Round - 7,438,Velez Sarsfield,1064,Platense,1,1,Velez Sarsfield,25,27,Platense,17,34,-7,-8
2023,128,Liga Profesional Argentina,971430,2023-03-14T00:00:00+00:00,Round - 7,448,Colon Santa Fe,457,Newells Old Boys,1,1,Colon Santa Fe,27,25,Newells Old Boys,14,35,-10,-13
2023,128,Liga Profesional Argentina,971443,2023-03-18T00:00:00+00:00,Round - 8,441,Union Santa Fe,436,Racing Club,1,3,Union Santa Fe,20,30,Racing Club,12,36,-6,-8
2023,128,Liga Profesional Argentina,971446,2023-03-18T19:30:00+00:00,Round - 8,459,Arsenal Sarandi,452,Tigre,2,0,Arsenal Sarandi,28,22,Tigre,16,34,-12,-12
2023,128,Liga Profesional Argentina,971439,2023-03-18T22:00:00+00:00,Round - 8,453,Independiente,448,Colon Santa Fe,2,2,Independiente,24,28,Colon Santa Fe,27,25,3,3
2023,128,Liga Profesional Argentina,971436,2023-03-18T22:00:00+00:00,Round - 8,1064,Platense,442,Defensa Y Justicia,1,0,Platense,17,34,Defensa Y Justicia,6,44,-10,-11
2023,128,Liga Profesional Argentina,971444,2023-03-19T00:30:00+00:00,Round - 8,439,Godoy Cruz,440,Belgrano Cordoba,3,1,Godoy Cruz,9,41,Belgrano Cordoba,13,36,5,4
2023,128,Liga Profesional Argentina,971438,2023-03-19T00:30:00+00:00,Round - 8,455,Atletico Tucuman,2432,Barracas Central,1,1,Atletico Tucuman,11,37,Barracas Central,15,35,2,4
2023,128,Liga Profesional Argentina,971441,2023-03-19T19:30:00+00:00,Round - 8,434,Gimnasia L.P.,450,Estudiantes L.P.,2,1,Gimnasia L.P.,22,30,Estudiantes L.P.,5,45,-15,-17
2023,128,Liga Profesional Argentina,988710,2023-03-19T22:00:00+00:00,Round - 8,451,Boca Juniors,478,Instituto Cordoba,2,3,Boca Juniors,7,44,Instituto Cordoba,18,32,12,11
2023,128,Liga Profesional Argentina,971437,2023-03-20T00:30:00+00:00,Round - 8,456,Talleres Cordoba,449,Banfield,0,1,Talleres Cordoba,2,50,Banfield,21,30,20,19
2023,128,Liga Profesional Argentina,988711,2023-03-20T00:30:00+00:00,Round - 8,474,Sarmiento Junin,435,River Plate,0,2,Sarmiento Junin,19,30,River Plate,1,61,-31,-18
2023,128,Liga Profesional Argentina,971440,2023-03-20T21:30:00+00:00,Round - 8,457,Newells Old Boys,460,San Lorenzo,1,0,Newells Old Boys,14,35,San Lorenzo,3,46,-11,-11
2023,128,Liga Profesional Argentina,971442,2023-03-21T00:00:00+00:00,Round - 8,445,Huracan,437,Rosario Central,0,2,Huracan,26,25,Rosario Central,8,42,-17,-18
2023,128,Liga Profesional Argentina,971445,2023-03-21T00:00:00+00:00,Round - 8,446,Lanus,458,Argentinos JRS,0,0,Lanus,4,45,Argentinos JRS,10,40,5,6
2023,128,Liga Profesional Argentina,971435,2023-03-22T00:00:00+00:00,Round - 8,438,Velez Sarsfield,1065,Central Cordoba de Santiago,4,0,Velez Sarsfield,25,27,Central Cordoba de Santiago,23,29,-2,-2
2023,128,Liga Profesional Argentina,971458,2023-03-30T23:00:00+00:00,Round - 9,442,Defensa Y Justicia,438,Velez Sarsfield,0,0,Defensa Y Justicia,6,44,Velez Sarsfield,25,27,17,19
2023,128,Liga Profesional Argentina,971449,2023-03-31T00:30:00+00:00,Round - 9,458,Argentinos JRS,439,Godoy Cruz,3,0,Argentinos JRS,10,40,Godoy Cruz,9,41,-1,-1
2023,128,Liga Profesional Argentina,971452,2023-03-31T22:00:00+00:00,Round - 9,437,Rosario Central,434,Gimnasia L.P.,3,1,Rosario Central,8,42,Gimnasia L.P.,22,30,12,14
2023,128,Liga Profesional Argentina,971453,2023-03-31T22:00:00+00:00,Round - 9,450,Estudiantes L.P.,457,Newells Old Boys,3,0,Estudiantes L.P.,5,45,Newells Old Boys,14,35,10,9
2023,128,Liga Profesional Argentina,971450,2023-04-01T00:30:00+00:00,Round - 9,435,River Plate,441,Union Santa Fe,1,0,River Plate,1,61,Union Santa Fe,20,30,31,19
2023,128,Liga Profesional Argentina,971456,2023-04-01T18:30:00+00:00,Round - 9,2432,Barracas Central,451,Boca Juniors,0,3,Barracas Central,15,35,Boca Juniors,7,44,-9,-8
2023,128,Liga Profesional Argentina,971454,2023-04-01T22:00:00+00:00,Round - 9,460,San Lorenzo,453,Independiente,0,0,San Lorenzo,3,46,Independiente,24,28,18,21
2023,128,Liga Profesional Argentina,971451,2023-04-01T22:30:00+00:00,Round - 9,436,Racing Club,445,Huracan,2,1,Racing Club,12,36,Huracan,26,25,11,14
2023,128,Liga Profesional Argentina,971448,2023-04-02T00:30:00+00:00,Round - 9,452,Tigre,446,Lanus,2,1,Tigre,16,34,Lanus,4,45,-11,-12
2023,128,Liga Profesional Argentina,988713,2023-04-02T19:30:00+00:00,Round - 9,478,Instituto Cordoba,456,Talleres Cordoba,0,3,Instituto Cordoba,18,32,Talleres Cordoba,2,50,-18,-16
2023,128,Liga Profesional Argentina,971455,2023-04-02T22:00:00+00:00,Round - 9,448,Colon Santa Fe,455,Atletico Tucuman,0,0,Colon Santa Fe,27,25,Atletico Tucuman,11,37,-12,-16
2023,128,Liga Profesional Argentina,971457,2023-04-03T00:30:00+00:00,Round - 9,449,Banfield,1064,Platense,0,2,Banfield,21,30,Platense,17,34,-4,-4
2023,128,Liga Profesional Argentina,988712,2023-04-03T23:00:00+00:00,Round - 9,440,Belgrano Cordoba,474,Sarmiento Junin,0,0,Belgrano Cordoba,13,36,Sarmiento Junin,19,30,6,6
2023,128,Liga Profesional Argentina,971447,2023-04-04T00:30:00+00:00,Round - 9,1065,Central Cordoba de Santiago,459,Arsenal Sarandi,1,0,Central Cordoba de Santiago,23,29,Arsenal Sarandi,28,22,7,5
2023,128,Liga Profesional Argentina,971470,2023-04-07T22:00:00+00:00,Round - 10,446,Lanus,459,Arsenal Sarandi,3,0,Lanus,4,45,Arsenal Sarandi,28,22,23,24
2023,128,Liga Profesional Argentina,988714,2023-04-07T22:00:00+00:00,Round - 10,1064,Platense,478,Instituto Cordoba,1,0,Platense,17,34,Instituto Cordoba,18,32,2,1
2023,128,Liga Profesional Argentina,971460,2023-04-08T00:30:00+00:00,Round - 10,438,Velez Sarsfield,449,Banfield,3,3,Velez Sarsfield,25,27,Banfield,21,30,-3,-4
2023,128,Liga Profesional Argentina,971461,2023-04-08T00:30:00+00:00,Round - 10,456,Talleres Cordoba,2432,Barracas Central,3,0,Talleres Cordoba,2,50,Barracas Central,15,35,15,13
2023,128,Liga Profesional Argentina,988715,2023-04-08T18:30:00+00:00,Round - 10,474,Sarmiento Junin,458,Argentinos JRS,2,0,Sarmiento Junin,19,30,Argentinos JRS,10,40,-10,-9
2023,128,Liga Profesional Argentina,971466,2023-04-08T21:00:00+00:00,Round - 10,434,Gimnasia L.P.,436,Racing Club,3,1,Gimnasia L.P.,22,30,Racing Club,12,36,-6,-10
2023,128,Liga Profesional Argentina,971468,2023-04-08T21:00:00+00:00,Round - 10,441,Union Santa Fe,440,Belgrano Cordoba,0,3,Union Santa Fe,20,30,Belgrano Cordoba,13,36,-6,-7
2023,128,Liga Profesional Argentina,971459,2023-04-08T23:30:00+00:00,Round - 10,442,Defensa Y Justicia,1065,Central Cordoba de Santiago,1,2,Defensa Y Justicia,6,44,Central Cordoba de Santiago,23,29,15,17
2023,128,Liga Profesional Argentina,971463,2023-04-08T23:30:00+00:00,Round - 10,455,Atletico Tucuman,460,San Lorenzo,1,3,Atletico Tucuman,11,37,San Lorenzo,3,46,-9,-8
2023,128,Liga Profesional Argentina,971469,2023-04-09T17:00:00+00:00,Round - 10,439,Godoy Cruz,452,Tigre,1,1,Godoy Cruz,9,41,Tigre,16,34,7,7
2023,128,Liga Profesional Argentina,971464,2023-04-09T17:00:00+00:00,Round - 10,453,Independiente,450,Estudiantes L.P.,1,2,Independiente,24,28,Estudiantes L.P.,5,45,-17,-19
2023,128,Liga Profesional Argentina,971465,2023-04-09T19:30:00+00:00,Round - 10,457,Newells Old Boys,437,Rosario Central,0,0,Newells Old Boys,14,35,Rosario Central,8,42,-7,-6
2023,128,Liga Profesional Argentina,971467,2023-04-09T22:00:00+00:00,Round - 10,445,Huracan,435,River Plate,0,3,Huracan,26,25,River Plate,1,61,-36,-25
2023,128,Liga Profesional Argentina,971462,2023-04-10T00:30:00+00:00,Round - 10,451,Boca Juniors,448,Colon Santa Fe,1,2,Boca Juniors,7,44,Colon Santa Fe,27,25,19,20
2023,128,Liga Profesional Argentina,971481,2023-04-11T17:00:00+00:00,Round - 11,2432,Barracas Central,1064,Platense,1,0,Barracas Central,15,35,Platense,17,34,1,2
2023,128,Liga Profesional Argentina,971473,2023-04-11T22:00:00+00:00,Round - 11,458,Argentinos JRS,441,Union Santa Fe,5,1,Argentinos JRS,10,40,Union Santa Fe,20,30,10,10
2023,128,Liga Profesional Argentina,971482,2023-04-12T00:30:00+00:00,Round - 11,449,Banfield,442,Defensa Y Justicia,0,3,Banfield,21,30,Defensa Y Justicia,6,44,-14,-15
2023,128,Liga Profesional Argentina,988717,2023-04-12T00:30:00+00:00,Round - 11,478,Instituto Cordoba,438,Velez Sarsfield,1,0,Instituto Cordoba,18,32,Velez Sarsfield,25,27,5,7
2023,128,Liga Profesional Argentina,971471,2023-04-12T00:30:00+00:00,Round - 11,1065,Central Cordoba de Santiago,446,Lanus,1,1,Central Cordoba de Santiago,23,29,Lanus,4,45,-16,-19
2023,128,Liga Profesional Argentina,971479,2023-04-12T20:30:00+00:00,Round - 11,460,San Lorenzo,451,Boca Juniors,1,0,San Lorenzo,3,46,Boca Juniors,7,44,2,4
2023,128,Liga Profesional Argentina,971474,2023-04-12T22:00:00+00:00,Round - 11,440,Belgrano Cordoba,445,Huracan,2,0,Belgrano Cordoba,13,36,Huracan,26,25,11,13
2023,128,Liga Profesional Argentina,971476,2023-04-12T22:30:00+00:00,Round - 11,436,Racing Club,457,Newells Old Boys,0,1,Racing Club,12,36,Newells Old Boys,14,35,1,2
2023,128,Liga Profesional Argentina,971477,2023-04-13T00:30:00+00:00,Round - 11,437,Rosario Central,453,Independiente,1,0,Rosario Central,8,42,Independiente,24,28,14,16
2023,128,Liga Profesional Argentina,971478,2023-04-13T00:30:00+00:00,Round - 11,450,Estudiantes L.P.,455,Atletico Tucuman,0,0,Estudiantes L.P.,5,45,Atletico Tucuman,11,37,8,6
2023,128,Liga Profesional Argentina,971472,2023-04-13T17:00:00+00:00,Round - 11,459,Arsenal Sarandi,439,Godoy Cruz,2,3,Arsenal Sarandi,28,22,Godoy Cruz,9,41,-19,-19
2023,128,Liga Profesional Argentina,971480,2023-04-13T19:30:00+00:00,Round - 11,448,Colon Santa Fe,456,Talleres Cordoba,2,2,Colon Santa Fe,27,25,Talleres Cordoba,2,50,-25,-25
2023,128,Liga Profesional Argentina,971475,2023-04-13T22:30:00+00:00,Round - 11,435,River Plate,434,Gimnasia L.P.,3,0,River Plate,1,61,Gimnasia L.P.,22,30,31,21
2023,128,Liga Profesional Argentina,988716,2023-04-14T00:30:00+00:00,Round - 11,452,Tigre,474,Sarmiento Junin,1,0,Tigre,16,34,Sarmiento Junin,19,30,4,3
2023,128,Liga Profesional Argentina,988718,2023-04-15T19:30:00+00:00,Round - 12,442,Defensa Y Justicia,478,Instituto Cordoba,1,0,Defensa Y Justicia,6,44,Instituto Cordoba,18,32,12,12
2023,128,Liga Profesional Argentina,971487,2023-04-15T22:00:00+00:00,Round - 12,451,Boca Juniors,450,Estudiantes L.P.,0,1,Boca Juniors,7,44,Estudiantes L.P.,5,45,-1,-2
2023,128,Liga Profesional Argentina,971491,2023-04-16T00:30:00+00:00,Round - 12,434,Gimnasia L.P.,440,Belgrano Cordoba,0,2,Gimnasia L.P.,22,30,Belgrano Cordoba,13,36,-6,-9
2023,128,Liga Profesional Argentina,971492,2023-04-16T00:30:00+00:00,Round - 12,445,Huracan,458,Argentinos JRS,0,0,Huracan,26,25,Argentinos JRS,10,40,-15,-16
2023,128,Liga Profesional Argentina,971484,2023-04-16T17:00:00+00:00,Round - 12,438,Velez Sarsfield,2432,Barracas Central,0,0,Velez Sarsfield,25,27,Barracas Central,15,35,-8,-10
2023,128,Liga Profesional Argentina,971493,2023-04-16T17:00:00+00:00,Round - 12,441,Union Santa Fe,452,Tigre,0,0,Union Santa Fe,20,30,Tigre,16,34,-4,-4
2023,128,Liga Profesional Argentina,971489,2023-04-16T19:30:00+00:00,Round - 12,453,Independiente,436,Racing Club,1,1,Independiente,24,28,Racing Club,12,36,-8,-12
2023,128,Liga Profesional Argentina,971490,2023-04-16T22:00:00+00:00,Round - 12,457,Newells Old Boys,435,River Plate,0,1,Newells Old Boys,14,35,River Plate,1,61,-26,-13
2023,128,Liga Profesional Argentina,971486,2023-04-17T00:30:00+00:00,Round - 12,456,Talleres Cordoba,460,San Lorenzo,0,0,Talleres Cordoba,2,50,San Lorenzo,3,46,4,1
2023,128,Liga Profesional Argentina,971485,2023-04-17T19:30:00+00:00,Round - 12,1064,Platense,448,Colon Santa Fe,0,0,Platense,17,34,Colon Santa Fe,27,25,9,10
2023,128,Liga Profesional Argentina,971483,2023-04-17T22:00:00+00:00,Round - 12,449,Banfield,1065,Central Cordoba de Santiago,1,0,Banfield,21,30,Central Cordoba de Santiago,23,29,1,2
2023,128,Liga Profesional Argentina,988719,2023-04-17T22:00:00+00:00,Round - 12,474,Sarmiento Junin,459,Arsenal Sarandi,1,0,Sarmiento Junin,19,30,Arsenal Sarandi,28,22,8,9
2023,128,Liga Profesional Argentina,971494,2023-04-18T00:30:00+00:00,Round - 12,439,Godoy Cruz,446,Lanus,4,4,Godoy Cruz,9,41,Lanus,4,45,-4,-5
2023,128,Liga Profesional Argentina,971488,2023-04-18T00:30:00+00:00,Round - 12,455,Atletico Tucuman,437,Rosario Central,2,2,Atletico Tucuman,11,37,Rosario Central,8,42,-5,-3
2023,128,Liga Profesional Argentina,971505,2023-04-21T23:30:00+00:00,Round - 13,448,Colon Santa Fe,438,Velez Sarsfield,2,1,Colon Santa Fe,27,25,Velez Sarsfield,25,27,-2,-2
2023,128,Liga Profesional Argentina,988720,2023-04-22T18:30:00+00:00,Round - 13,446,Lanus,474,Sarmiento Junin,2,1,Lanus,4,45,Sarmiento Junin,19,30,15,15
2023,128,Liga Profesional Argentina,971496,2023-04-22T18:30:00+00:00,Round - 13,459,Arsenal Sarandi,441,Union Santa Fe,2,1,Arsenal Sarandi,28,22,Union Santa Fe,20,30,-8,-8
2023,128,Liga Profesional Argentina,971499,2023-04-22T23:30:00+00:00,Round - 13,440,Belgrano Cordoba,457,Newells Old Boys,1,0,Belgrano Cordoba,13,36,Newells Old Boys,14,35,1,1
2023,128,Liga Profesional Argentina,971495,2023-04-22T23:30:00+00:00,Round - 13,1065,Central Cordoba de Santiago,439,Godoy Cruz,0,2,Central Cordoba de Santiago,23,29,Godoy Cruz,9,41,-12,-14
2023,128,Liga Profesional Argentina,971504,2023-04-23T14:00:00+00:00,Round - 13,460,San Lorenzo,1064,Platense,1,0,San Lorenzo,3,46,Platense,17,34,12,14
2023,128,Liga Profesional Argentina,971502,2023-04-23T18:30:00+00:00,Round - 13,437,Rosario Central,451,Boca Juniors,2,2,Rosario Central,8,42,Boca Juniors,7,44,-2,-1
2023,128,Liga Profesional Argentina,988721,2023-04-23T20:30:00+00:00,Round - 13,478,Instituto Cordoba,449,Banfield,1,1,Instituto Cordoba,18,32,Banfield,21,30,2,3
2023,128,Liga Profesional Argentina,971503,2023-04-23T21:00:00+00:00,Round - 13,450,Estudiantes L.P.,456,Talleres Cordoba,1,0,Estudiantes L.P.,5,45,Talleres Cordoba,2,50,-5,-3
2023,128,Liga Profesional Argentina,971500,2023-04-23T23:30:00+00:00,Round - 13,435,River Plate,453,Independiente,2,0,River Plate,1,61,Independiente,24,28,33,23
2023,128,Liga Profesional Argentina,971506,2023-04-24T18:30:00+00:00,Round - 13,2432,Barracas Central,442,Defensa Y Justicia,0,2,Barracas Central,15,35,Defensa Y Justicia,6,44,-9,-9
2023,128,Liga Profesional Argentina,971501,2023-04-24T22:00:00+00:00,Round - 13,436,Racing Club,455,Atletico Tucuman,1,3,Racing Club,12,36,Atletico Tucuman,11,37,-1,-1
2023,128,Liga Profesional Argentina,971498,2023-04-25T00:30:00+00:00,Round - 13,458,Argentinos JRS,434,Gimnasia L.P.,2,4,Argentinos JRS,10,40,Gimnasia L.P.,22,30,10,12
2023,128,Liga Profesional Argentina,971497,2023-04-25T22:30:00+00:00,Round - 13,452,Tigre,445,Huracan,1,0,Tigre,16,34,Huracan,26,25,9,10
2023,128,Liga Profesional Argentina,988723,2023-04-27T23:00:00+00:00,Round - 14,474,Sarmiento Junin,439,Godoy Cruz,1,1,Sarmiento Junin,19,30,Godoy Cruz,9,41,-11,-10
2023,128,Liga Profesional Argentina,971510,2023-04-27T23:00:00+00:00,Round - 14,1064,Platense,450,Estudiantes L.P.,1,2,Platense,17,34,Estudiantes L.P.,5,45,-11,-12
2023,128,Liga Profesional Argentina,971517,2023-04-28T22:00:00+00:00,Round - 14,445,Huracan,459,Arsenal Sarandi,2,1,Huracan,26,25,Arsenal Sarandi,28,22,3,2
2023,128,Liga Profesional Argentina,971515,2023-04-28T22:00:00+00:00,Round - 14,457,Newells Old Boys,458,Argentinos JRS,0,0,Newells Old Boys,14,35,Argentinos JRS,10,40,-5,-4
2023,128,Liga Profesional Argentina,971513,2023-04-29T00:30:00+00:00,Round - 14,455,Atletico Tucuman,435,River Plate,1,1,Atletico Tucuman,11,37,River Plate,1,61,-24,-10
2023,128,Liga Profesional Argentina,971509,2023-04-29T17:00:00+00:00,Round - 14,438,Velez Sarsfield,460,San Lorenzo,0,0,Velez Sarsfield,25,27,San Lorenzo,3,46,-19,-22
2023,128,Liga Profesional Argentina,971516,2023-04-29T19:30:00+00:00,Round - 14,434,Gimnasia L.P.,452,Tigre,1,1,Gimnasia L.P.,22,30,Tigre,16,34,-4,-6
2023,128,Liga Profesional Argentina,971507,2023-04-29T22:00:00+00:00,Round - 14,449,Banfield,2432,Barracas Central,0,0,Banfield,21,30,Barracas Central,15,35,-5,-6
2023,128,Liga Profesional Argentina,988722,2023-04-29T22:00:00+00:00,Round - 14,478,Instituto Cordoba,1065,Central Cordoba de Santiago,0,2,Instituto Cordoba,18,32,Central Cordoba de Santiago,23,29,3,5
2023,128,Liga Profesional Argentina,971512,2023-04-30T00:30:00+00:00,Round - 14,451,Boca Juniors,436,Racing Club,3,1,Boca Juniors,7,44,Racing Club,12,36,8,5
2023,128,Liga Profesional Argentina,971508,2023-04-30T18:30:00+00:00,Round - 14,442,Defensa Y Justicia,448,Colon Santa Fe,2,0,Defensa Y Justicia,6,44,Colon Santa Fe,27,25,19,21
2023,128,Liga Profesional Argentina,971514,2023-04-30T21:00:00+00:00,Round - 14,453,Independiente,440,Belgrano Cordoba,2,0,Independiente,24,28,Belgrano Cordoba,13,36,-8,-11
2023,128,Liga Profesional Argentina,971511,2023-04-30T23:30:00+00:00,Round - 14,456,Talleres Cordoba,437,Rosario Central,3,1,Talleres Cordoba,2,50,Rosario Central,8,42,8,6
2023,128,Liga Profesional Argentina,971519,2023-05-05T18:30:00+00:00,Round - 15,439,Godoy Cruz,441,Union Santa Fe,0,0,Godoy Cruz,9,41,Union Santa Fe,20,30,11,11
2023,128,Liga Profesional Argentina,988725,2023-05-05T18:30:00+00:00,Round - 15,2432,Barracas Central,478,Instituto Cordoba,3,0,Barracas Central,15,35,Instituto Cordoba,18,32,3,3
2023,128,Liga Profesional Argentina,971520,2023-05-06T18:30:00+00:00,Round - 15,446,Lanus,445,Huracan,1,0,Lanus,4,45,Huracan,26,25,20,22
2023,128,Liga Profesional Argentina,971524,2023-05-06T21:00:00+00:00,Round - 15,440,Belgrano Cordoba,455,Atletico Tucuman,1,0,Belgrano Cordoba,13,36,Atletico Tucuman,11,37,-1,-2
2023,128,Liga Profesional Argentina,971530,2023-05-06T21:00:00+00:00,Round - 15,448,Colon Santa Fe,449,Banfield,2,0,Colon Santa Fe,27,25,Banfield,21,30,-5,-6
2023,128,Liga Profesional Argentina,971523,2023-05-06T23:30:00+00:00,Round - 15,458,Argentinos JRS,453,Independiente,2,2,Argentinos JRS,10,40,Independiente,24,28,12,14
2023,128,Liga Profesional Argentina,971527,2023-05-07T17:00:00+00:00,Round - 15,437,Rosario Central,1064,Platense,4,0,Rosario Central,8,42,Platense,17,34,8,9
2023,128,Liga Profesional Argentina,971525,2023-05-07T20:30:00+00:00,Round - 15,435,River Plate,451,Boca Juniors,1,0,River Plate,1,61,Boca Juniors,7,44,17,6
2023,128,Liga Profesional Argentina,971528,2023-05-08T00:00:00+00:00,Round - 15,450,Estudiantes L.P.,438,Velez Sarsfield,2,0,Estudiantes L.P.,5,45,Velez Sarsfield,25,27,18,20
2023,128,Liga Profesional Argentina,971522,2023-05-08T00:00:00+00:00,Round - 15,452,Tigre,457,Newells Old Boys,2,2,Tigre,16,34,Newells Old Boys,14,35,-1,-2
2023,128,Liga Profesional Argentina,971521,2023-05-08T18:30:00+00:00,Round - 15,459,Arsenal Sarandi,434,Gimnasia L.P.,0,1,Arsenal Sarandi,28,22,Gimnasia L.P.,22,30,-8,-6
2023,128,Liga Profesional Argentina,971529,2023-05-08T20:00:00+00:00,Round - 15,460,San Lorenzo,442,Defensa Y Justicia,0,0,San Lorenzo,3,46,Defensa Y Justicia,6,44,2,3
2023,128,Liga Profesional Argentina,971526,2023-05-08T22:30:00+00:00,Round - 15,436,Racing Club,456,Talleres Cordoba,2,4,Racing Club,12,36,Talleres Cordoba,2,50,-14,-10
2023,128,Liga Profesional Argentina,988724,2023-05-09T00:30:00+00:00,Round - 15,1065,Central Cordoba de Santiago,474,Sarmiento Junin,0,1,Central Cordoba de Santiago,23,29,Sarmiento Junin,19,30,-1,-4
2023,128,Liga Profesional Argentina,971542,2023-05-12T23:00:00+00:00,Round - 16,445,Huracan,439,Godoy Cruz,0,0,Huracan,26,25,Godoy Cruz,9,41,-16,-17
2023,128,Liga Profesional Argentina,971538,2023-05-13T00:30:00+00:00,Round - 16,455,Atletico Tucuman,458,Argentinos JRS,1,2,Atletico Tucuman,11,37,Argentinos JRS,10,40,-3,-1
2023,128,Liga Profesional Argentina,971539,2023-05-13T18:30:00+00:00,Round - 16,453,Independiente,452,Tigre,2,1,Independiente,24,28,Tigre,16,34,-6,-8
2023,128,Liga Profesional Argentina,971532,2023-05-13T21:00:00+00:00,Round - 16,449,Banfield,460,San Lorenzo,1,2,Banfield,21,30,San Lorenzo,3,46,-16,-18
2023,128,Liga Profesional Argentina,971540,2023-05-13T23:30:00+00:00,Round - 16,457,Newells Old Boys,459,Arsenal Sarandi,2,0,Newells Old Boys,14,35,Arsenal Sarandi,28,22,13,14
2023,128,Liga Profesional Argentina,988726,2023-05-13T23:30:00+00:00,Round - 16,478,Instituto Cordoba,448,Colon Santa Fe,1,0,Instituto Cordoba,18,32,Colon Santa Fe,27,25,7,9
2023,128,Liga Profesional Argentina,971533,2023-05-14T17:00:00+00:00,Round - 16,442,Defensa Y Justicia,450,Estudiantes L.P.,1,1,Defensa Y Justicia,6,44,Estudiantes L.P.,5,45,-1,-1
2023,128,Liga Profesional Argentina,971535,2023-05-14T19:30:00+00:00,Round - 16,1064,Platense,436,Racing Club,3,0,Platense,17,34,Racing Club,12,36,-2,-5
2023,128,Liga Profesional Argentina,971537,2023-05-14T22:00:00+00:00,Round - 16,451,Boca Juniors,440,Belgrano Cordoba,2,0,Boca Juniors,7,44,Belgrano Cordoba,13,36,8,6
2023,128,Liga Profesional Argentina,971536,2023-05-15T00:30:00+00:00,Round - 16,456,Talleres Cordoba,435,River Plate,2,1,Talleres Cordoba,2,50,River Plate,1,61,-11,-1
2023,128,Liga Profesional Argentina,988727,2023-05-15T18:30:00+00:00,Round - 16,441,Union Santa Fe,474,Sarmiento Junin,0,2,Union Santa Fe,20,30,Sarmiento Junin,19,30,0,-1
2023,128,Liga Profesional Argentina,971531,2023-05-15T18:30:00+00:00,Round - 16,2432,Barracas Central,1065,Central Cordoba de Santiago,2,2,Barracas Central,15,35,Central Cordoba de Santiago,23,29,6,8
2023,128,Liga Profesional Argentina,971541,2023-05-15T21:00:00+00:00,Round - 16,434,Gimnasia L.P.,446,Lanus,1,0,Gimnasia L.P.,22,30,Lanus,4,45,-15,-18
2023,128,Liga Profesional Argentina,971534,2023-05-15T23:30:00+00:00,Round - 16,438,Velez Sarsfield,437,Rosario Central,0,0,Velez Sarsfield,25,27,Rosario Central,8,42,-15,-17
2023,128,Liga Profesional Argentina,971546,2023-05-19T00:00:00+00:00,Round - 17,459,Arsenal Sarandi,453,Independiente,2,1,Arsenal Sarandi,28,22,Independiente,24,28,-6,-4
2023,128,Liga Profesional Argentina,971544,2023-05-19T18:30:00+00:00,Round - 17,439,Godoy Cruz,434,Gimnasia L.P.,2,0,Godoy Cruz,9,41,Gimnasia L.P.,22,30,11,13
2023,128,Liga Profesional Argentina,971552,2023-05-19T22:00:00+00:00,Round - 17,437,Rosario Central,442,Defensa Y Justicia,2,1,Rosario Central,8,42,Defensa Y Justicia,6,44,-2,-2
2023,128,Liga Profesional Argentina,971553,2023-05-19T22:00:00+00:00,Round - 17,450,Estudiantes L.P.,449,Banfield,1,0,Estudiantes L.P.,5,45,Banfield,21,30,15,16
2023,128,Liga Profesional Argentina,971543,2023-05-19T22:00:00+00:00,Round - 17,1065,Central Cordoba de Santiago,441,Union Santa Fe,0,1,Central Cordoba de Santiago,23,29,Union Santa Fe,20,30,-1,-3
2023,128,Liga Profesional Argentina,971548,2023-05-20T00:30:00+00:00,Round - 17,458,Argentinos JRS,451,Boca Juniors,0,1,Argentinos JRS,10,40,Boca Juniors,7,44,-4,-3
2023,128,Liga Profesional Argentina,988729,2023-05-20T17:00:00+00:00,Round - 17,460,San Lorenzo,478,Instituto Cordoba,2,0,San Lorenzo,3,46,Instituto Cordoba,18,32,14,15
2023,128,Liga Profesional Argentina,971545,2023-05-21T00:30:00+00:00,Round - 17,446,Lanus,457,Newells Old Boys,1,0,Lanus,4,45,Newells Old Boys,14,35,10,10
2023,128,Liga Profesional Argentina,971547,2023-05-21T00:30:00+00:00,Round - 17,452,Tigre,455,Atletico Tucuman,0,0,Tigre,16,34,Atletico Tucuman,11,37,-3,-5
2023,128,Liga Profesional Argentina,971549,2023-05-21T18:30:00+00:00,Round - 17,440,Belgrano Cordoba,456,Talleres Cordoba,1,1,Belgrano Cordoba,13,36,Talleres Cordoba,2,50,-14,-11
2023,128,Liga Profesional Argentina,971554,2023-05-21T21:00:00+00:00,Round - 17,448,Colon Santa Fe,2432,Barracas Central,1,1,Colon Santa Fe,27,25,Barracas Central,15,35,-10,-12
2023,128,Liga Profesional Argentina,988728,2023-05-21T21:00:00+00:00,Round - 17,474,Sarmiento Junin,445,Huracan,0,0,Sarmiento Junin,19,30,Huracan,26,25,5,7
2023,128,Liga Profesional Argentina,971550,2023-05-21T23:30:00+00:00,Round - 17,435,River Plate,1064,Platense,2,1,River Plate,1,61,Platense,17,34,27,16
2023,128,Liga Profesional Argentina,971563,2023-05-27T00:30:00+00:00,Round - 18,455,Atletico Tucuman,459,Arsenal Sarandi,1,0,Atletico Tucuman,11,37,Arsenal Sarandi,28,22,15,17
2023,128,Liga Profesional Argentina,988731,2023-05-27T14:00:00+00:00,Round - 18,434,Gimnasia L.P.,474,Sarmiento Junin,0,0,Gimnasia L.P.,22,30,Sarmiento Junin,19,30,0,-3
2023,128,Liga Profesional Argentina,971560,2023-05-27T21:00:00+00:00,Round - 18,1064,Platense,440,Belgrano Cordoba,1,0,Platense,17,34,Belgrano Cordoba,13,36,-2,-4
2023,128,Liga Profesional Argentina,971564,2023-05-27T23:30:00+00:00,Round - 18,453,Independiente,446,Lanus,1,1,Independiente,24,28,Lanus,4,45,-17,-20
2023,128,Liga Profesional Argentina,971556,2023-05-28T17:00:00+00:00,Round - 18,2432,Barracas Central,460,San Lorenzo,1,0,Barracas Central,15,35,San Lorenzo,3,46,-11,-12
2023,128,Liga Profesional Argentina,971558,2023-05-28T19:30:00+00:00,Round - 18,442,Defensa Y Justicia,436,Racing Club,1,1,Defensa Y Justicia,6,44,Racing Club,12,36,8,6
2023,128,Liga Profesional Argentina,971561,2023-05-28T19:30:00+00:00,Round - 18,456,Talleres Cordoba,458,Argentinos JRS,1,0,Talleres Cordoba,2,50,Argentinos JRS,10,40,10,8
2023,128,Liga Profesional Argentina,971562,2023-05-28T22:00:00+00:00,Round - 18,451,Boca Juniors,452,Tigre,1,0,Boca Juniors,7,44,Tigre,16,34,10,9
2023,128,Liga Profesional Argentina,971565,2023-05-29T00:30:00+00:00,Round - 18,457,Newells Old Boys,439,Godoy Cruz,2,0,Newells Old Boys,14,35,Godoy Cruz,9,41,-6,-5
2023,128,Liga Profesional Argentina,971555,2023-05-29T19:30:00+00:00,Round - 18,448,Colon Santa Fe,1065,Central Cordoba de Santiago,2,2,Colon Santa Fe,27,25,Central Cordoba de Santiago,23,29,-4,-4
2023,128,Liga Profesional Argentina,971566,2023-05-29T22:00:00+00:00,Round - 18,445,Huracan,441,Union Santa Fe,0,1,Huracan,26,25,Union Santa Fe,20,30,-5,-6
2023,128,Liga Profesional Argentina,971557,2023-05-29T22:00:00+00:00,Round - 18,449,Banfield,437,Rosario Central,2,0,Banfield,21,30,Rosario Central,8,42,-12,-13
2023,128,Liga Profesional Argentina,988730,2023-05-29T23:00:00+00:00,Round - 18,478,Instituto Cordoba,450,Estudiantes L.P.,0,0,Instituto Cordoba,18,32,Estudiantes L.P.,5,45,-13,-13
2023,128,Liga Profesional Argentina,971559,2023-05-30T00:30:00+00:00,Round - 18,438,Velez Sarsfield,435,River Plate,2,2,Velez Sarsfield,25,27,River Plate,1,61,-34,-24
2023,128,Liga Profesional Argentina,988732,2023-06-01T23:00:00+00:00,Round - 19,474,Sarmiento Junin,457,Newells Old Boys,0,0,Sarmiento Junin,19,30,Newells Old Boys,14,35,-5,-5
2023,128,Liga Profesional Argentina,971571,2023-06-02T00:30:00+00:00,Round - 19,459,Arsenal Sarandi,451,Boca Juniors,1,0,Arsenal Sarandi,28,22,Boca Juniors,7,44,-22,-21
2023,128,Liga Profesional Argentina,971577,2023-06-02T22:00:00+00:00,Round - 19,450,Estudiantes L.P.,2432,Barracas Central,5,2,Estudiantes L.P.,5,45,Barracas Central,15,35,10,10
2023,128,Liga Profesional Argentina,971572,2023-06-03T00:30:00+00:00,Round - 19,452,Tigre,456,Talleres Cordoba,1,3,Tigre,16,34,Talleres Cordoba,2,50,-16,-14
2023,128,Liga Profesional Argentina,971573,2023-06-03T00:30:00+00:00,Round - 19,458,Argentinos JRS,1064,Platense,1,0,Argentinos JRS,10,40,Platense,17,34,6,7
2023,128,Liga Profesional Argentina,971574,2023-06-03T17:00:00+00:00,Round - 19,440,Belgrano Cordoba,438,Velez Sarsfield,2,0,Belgrano Cordoba,13,36,Velez Sarsfield,25,27,9,12
2023,128,Liga Profesional Argentina,988733,2023-06-03T22:00:00+00:00,Round - 19,437,Rosario Central,478,Instituto Cordoba,4,1,Rosario Central,8,42,Instituto Cordoba,18,32,10,10
2023,128,Liga Profesional Argentina,971567,2023-06-03T22:00:00+00:00,Round - 19,1065,Central Cordoba de Santiago,445,Huracan,2,0,Central Cordoba de Santiago,23,29,Huracan,26,25,4,3
2023,128,Liga Profesional Argentina,971576,2023-06-04T00:30:00+00:00,Round - 19,436,Racing Club,449,Banfield,2,0,Racing Club,12,36,Banfield,21,30,6,9
2023,128,Liga Profesional Argentina,971568,2023-06-04T14:00:00+00:00,Round - 19,441,Union Santa Fe,434,Gimnasia L.P.,2,0,Union Santa Fe,20,30,Gimnasia L.P.,22,30,0,2
2023,128,Liga Profesional Argentina,971578,2023-06-04T17:00:00+00:00,Round - 19,460,San Lorenzo,448,Colon Santa Fe,0,0,San Lorenzo,3,46,Colon Santa Fe,27,25,21,24
2023,128,Liga Profesional Argentina,971569,2023-06-04T20:00:00+00:00,Round - 19,439,Godoy Cruz,453,Independiente,2,1,Godoy Cruz,9,41,Independiente,24,28,13,15
2023,128,Liga Profesional Argentina,971570,2023-06-05T00:30:00+00:00,Round - 19,446,Lanus,455,Atletico Tucuman,2,1,Lanus,4,45,Atletico Tucuman,11,37,8,7
2023,128,Liga Profesional Argentina,971581,2023-06-09T18:30:00+00:00,Round - 20,2432,Barracas Central,437,Rosario Central,0,0,Barracas Central,15,35,Rosario Central,8,42,-7,-7
2023,128,Liga Profesional Argentina,988735,2023-06-09T23:00:00+00:00,Round - 20,453,Independiente,474,Sarmiento Junin,2,0,Independiente,24,28,Sarmiento Junin,19,30,-2,-5
2023,128,Liga Profesional Argentina,971585,2023-06-10T22:00:00+00:00,Round - 20,1064,Platense,452,Tigre,1,0,Platense,17,34,Tigre,16,34,0,-1
2023,128,Liga Profesional Argentina,971587,2023-06-10T23:00:00+00:00,Round - 20,451,Boca Juniors,446,Lanus,1,1,Boca Juniors,7,44,Lanus,4,45,-1,-3
2023,128,Liga Profesional Argentina,971586,2023-06-11T00:30:00+00:00,Round - 20,456,Talleres Cordoba,459,Arsenal Sarandi,1,0,Talleres Cordoba,2,50,Arsenal Sarandi,28,22,28,26
2023,128,Liga Profesional Argentina,971589,2023-06-12T17:00:00+00:00,Round - 20,457,Newells Old Boys,441,Union Santa Fe,1,1,Newells Old Boys,14,35,Union Santa Fe,20,30,5,6
2023,128,Liga Profesional Argentina,971579,2023-06-12T20:00:00+00:00,Round - 20,460,San Lorenzo,1065,Central Cordoba de Santiago,0,0,San Lorenzo,3,46,Central Cordoba de Santiago,23,29,17,20
2023,128,Liga Profesional Argentina,971582,2023-06-12T22:15:00+00:00,Round - 20,449,Banfield,435,River Plate,1,4,Banfield,21,30,River Plate,1,61,-31,-20
2023,128,Liga Profesional Argentina,971584,2023-06-13T00:45:00+00:00,Round - 20,438,Velez Sarsfield,458,Argentinos JRS,0,1,Velez Sarsfield,25,27,Argentinos JRS,10,40,-13,-15
2023,128,Liga Profesional Argentina,988734,2023-06-13T00:45:00+00:00,Round - 20,478,Instituto Cordoba,436,Racing Club,1,1,Instituto Cordoba,18,32,Racing Club,12,36,-4,-6
2023,128,Liga Profesional Argentina,971583,2023-06-13T21:00:00+00:00,Round - 20,442,Defensa Y Justicia,440,Belgrano Cordoba,2,0,Defensa Y Justicia,6,44,Belgrano Cordoba,13,36,8,7
2023,128,Liga Profesional Argentina,971580,2023-06-13T21:00:00+00:00,Round - 20,448,Colon Santa Fe,450,Estudiantes L.P.,1,0,Colon Santa Fe,27,25,Estudiantes L.P.,5,45,-20,-22
2023,128,Liga Profesional Argentina,971590,2023-06-13T23:30:00+00:00,Round - 20,434,Gimnasia L.P.,445,Huracan,1,0,Gimnasia L.P.,22,30,Huracan,26,25,5,4
2023,128,Liga Profesional Argentina,971588,2023-06-13T23:30:00+00:00,Round - 20,455,Atletico Tucuman,439,Godoy Cruz,2,1,Atletico Tucuman,11,37,Godoy Cruz,9,41,-4,-2
2023,128,Liga Profesional Argentina,971518,2023-06-17T18:30:00+00:00,Round - 14,441,Union Santa Fe,446,Lanus,1,1,Union Santa Fe,20,30,Lanus,4,45,-15,-16
2023,128,Liga Profesional Argentina,971551,2023-06-17T21:00:00+00:00,Round - 17,436,Racing Club,438,Velez Sarsfield,2,1,Racing Club,12,36,Velez Sarsfield,25,27,9,13
2023,128,Liga Profesional Argentina,971575,2023-06-18T19:30:00+00:00,Round - 19,435,River Plate,442,Defensa Y Justicia,1,0,River Plate,1,61,Defensa Y Justicia,6,44,17,5
2023,128,Liga Profesional Argentina,971602,2023-06-21T22:00:00+00:00,Round - 21,450,Estudiantes L.P.,460,San Lorenzo,1,1,Estudiantes L.P.,5,45,San Lorenzo,3,46,-1,-2
2023,128,Liga Profesional Argentina,971591,2023-06-22T00:30:00+00:00,Round - 21,1065,Central Cordoba de Santiago,434,Gimnasia L.P.,0,0,Central Cordoba de Santiago,23,29,Gimnasia L.P.,22,30,-1,-1
2023,128,Liga Profesional Argentina,971597,2023-06-22T20:00:00+00:00,Round - 21,452,Tigre,438,Velez Sarsfield,2,1,Tigre,16,34,Velez Sarsfield,25,27,7,9
2023,128,Liga Profesional Argentina,971600,2023-06-22T21:00:00+00:00,Round - 21,436,Racing Club,2432,Barracas Central,1,1,Racing Club,12,36,Barracas Central,15,35,1,3
2023,128,Liga Profesional Argentina,988737,2023-06-22T22:45:00+00:00,Round - 21,435,River Plate,478,Instituto Cordoba,3,1,River Plate,1,61,Instituto Cordoba,18,32,29,17
2023,128,Liga Profesional Argentina,971594,2023-06-23T00:45:00+00:00,Round - 21,439,Godoy Cruz,451,Boca Juniors,4,0,Godoy Cruz,9,41,Boca Juniors,7,44,-3,-2
2023,128,Liga Profesional Argentina,971592,2023-06-23T22:00:00+00:00,Round - 21,445,Huracan,457,Newells Old Boys,1,1,Huracan,26,25,Newells Old Boys,14,35,-10,-12
2023,128,Liga Profesional Argentina,971598,2023-06-24T00:30:00+00:00,Round - 21,458,Argentinos JRS,442,Defensa Y Justicia,3,1,Argentinos JRS,10,40,Defensa Y Justicia,6,44,-4,-4
2023,128,Liga Profesional Argentina,971593,2023-06-24T20:00:00+00:00,Round - 21,441,Union Santa Fe,453,Independiente,3,0,Union Santa Fe,20,30,Independiente,24,28,2,4
2023,128,Liga Profesional Argentina,971595,2023-06-24T23:00:00+00:00,Round - 21,446,Lanus,456,Talleres Cordoba,2,1,Lanus,4,45,Talleres Cordoba,2,50,-5,-2
2023,128,Liga Profesional Argentina,971596,2023-06-25T18:30:00+00:00,Round - 21,459,Arsenal Sarandi,1064,Platense,0,2,Arsenal Sarandi,28,22,Platense,17,34,-12,-11
2023,128,Liga Profesional Argentina,971601,2023-06-25T22:00:00+00:00,Round - 21,437,Rosario Central,448,Colon Santa Fe,1,1,Rosario Central,8,42,Colon Santa Fe,27,25,17,19
2023,128,Liga Profesional Argentina,988736,2023-06-25T23:30:00+00:00,Round - 21,474,Sarmiento Junin,455,Atletico Tucuman,4,1,Sarmiento Junin,19,30,Atletico Tucuman,11,37,-7,-8
2023,128,Liga Profesional Argentina,971599,2023-06-26T23:00:00+00:00,Round - 21,440,Belgrano Cordoba,449,Banfield,3,1,Belgrano Cordoba,13,36,Banfield,21,30,6,8
2023,128,Liga Profesional Argentina,971610,2023-06-30T22:00:00+00:00,Round - 22,1064,Platense,446,Lanus,0,1,Platense,17,34,Lanus,4,45,-11,-13
2023,128,Liga Profesional Argentina,971609,2023-07-01T00:30:00+00:00,Round - 22,438,Velez Sarsfield,459,Arsenal Sarandi,1,0,Velez Sarsfield,25,27,Arsenal Sarandi,28,22,5,3
2023,128,Liga Profesional Argentina,971612,2023-07-01T00:30:00+00:00,Round - 22,455,Atletico Tucuman,441,Union Santa Fe,1,0,Atletico Tucuman,11,37,Union Santa Fe,20,30,7,9
2023,128,Liga Profesional Argentina,971606,2023-07-01T18:00:00+00:00,Round - 22,2432,Barracas Central,435,River Plate,2,1,Barracas Central,15,35,River Plate,1,61,-26,-14
2023,128,Liga Profesional Argentina,971604,2023-07-01T20:30:00+00:00,Round - 22,460,San Lorenzo,437,Rosario Central,1,0,San Lorenzo,3,46,Rosario Central,8,42,4,5
2023,128,Liga Profesional Argentina,971603,2023-07-01T22:00:00+00:00,Round - 22,450,Estudiantes L.P.,1065,Central Cordoba de Santiago,1,1,Estudiantes L.P.,5,45,Central Cordoba de Santiago,23,29,16,18
2023,128,Liga Profesional Argentina,971611,2023-07-02T00:30:00+00:00,Round - 22,456,Talleres Cordoba,439,Godoy Cruz,1,1,Talleres Cordoba,2,50,Godoy Cruz,9,41,9,7
2023,128,Liga Profesional Argentina,971613,2023-07-02T18:00:00+00:00,Round - 22,453,Independiente,445,Huracan,1,0,Independiente,24,28,Huracan,26,25,3,2
2023,128,Liga Profesional Argentina,971605,2023-07-02T20:00:00+00:00,Round - 22,448,Colon Santa Fe,436,Racing Club,0,4,Colon Santa Fe,27,25,Racing Club,12,36,-11,-15
2023,128,Liga Profesional Argentina,988738,2023-07-02T22:00:00+00:00,Round - 22,478,Instituto Cordoba,440,Belgrano Cordoba,1,0,Instituto Cordoba,18,32,Belgrano Cordoba,13,36,-4,-5
2023,128,Liga Profesional Argentina,971608,2023-07-02T22:30:00+00:00,Round - 22,442,Defensa Y Justicia,452,Tigre,1,0,Defensa Y Justicia,6,44,Tigre,16,34,10,10
2023,128,Liga Profesional Argentina,971607,2023-07-02T22:30:00+00:00,Round - 22,449,Banfield,458,Argentinos JRS,1,0,Banfield,21,30,Argentinos JRS,10,40,-10,-11
2023,128,Liga Profesional Argentina,988739,2023-07-03T00:30:00+00:00,Round - 22,451,Boca Juniors,474,Sarmiento Junin,2,0,Boca Juniors,7,44,Sarmiento Junin,19,30,14,12
2023,128,Liga Profesional Argentina,971614,2023-07-03T23:00:00+00:00,Round - 22,457,Newells Old Boys,434,Gimnasia L.P.,2,2,Newells Old Boys,14,35,Gimnasia L.P.,22,30,5,8
2023,128,Liga Profesional Argentina,971620,2023-07-04T23:00:00+00:00,Round - 23,446,Lanus,438,Velez Sarsfield,0,1,Lanus,4,45,Velez Sarsfield,25,27,18,21
2023,128,Liga Profesional Argentina,971619,2023-07-05T18:30:00+00:00,Round - 23,439,Godoy Cruz,1064,Platense,2,1,Godoy Cruz,9,41,Platense,17,34,7,8
2023,128,Liga Profesional Argentina,971622,2023-07-05T20:00:00+00:00,Round - 23,452,Tigre,449,Banfield,1,2,Tigre,16,34,Banfield,21,30,4,5
2023,128,Liga Profesional Argentina,971626,2023-07-05T21:00:00+00:00,Round - 23,437,Rosario Central,450,Estudiantes L.P.,0,0,Rosario Central,8,42,Estudiantes L.P.,5,45,-3,-3
2023,128,Liga Profesional Argentina,971625,2023-07-05T22:30:00+00:00,Round - 23,436,Racing Club,460,San Lorenzo,1,1,Racing Club,12,36,San Lorenzo,3,46,-10,-9
2023,128,Liga Profesional Argentina,971624,2023-07-06T00:30:00+00:00,Round - 23,435,River Plate,448,Colon Santa Fe,2,0,River Plate,1,61,Colon Santa Fe,27,25,36,26
2023,128,Liga Profesional Argentina,971621,2023-07-06T17:00:00+00:00,Round - 23,459,Arsenal Sarandi,442,Defensa Y Justicia,1,2,Arsenal Sarandi,28,22,Defensa Y Justicia,6,44,-22,-22
2023,128,Liga Profesional Argentina,971618,2023-07-06T20:00:00+00:00,Round - 23,441,Union Santa Fe,451,Boca Juniors,0,0,Union Santa Fe,20,30,Boca Juniors,7,44,-14,-13
2023,128,Liga Profesional Argentina,988741,2023-07-06T22:00:00+00:00,Round - 23,458,Argentinos JRS,478,Instituto Cordoba,0,0,Argentinos JRS,10,40,Instituto Cordoba,18,32,8,8
2023,128,Liga Profesional Argentina,988740,2023-07-06T22:00:00+00:00,Round - 23,474,Sarmiento Junin,456,Talleres Cordoba,0,1,Sarmiento Junin,19,30,Talleres Cordoba,2,50,-20,-17
2023,128,Liga Profesional Argentina,971623,2023-07-07T00:30:00+00:00,Round - 23,440,Belgrano Cordoba,2432,Barracas Central,0,2,Belgrano Cordoba,13,36,Barracas Central,15,35,1,2
2023,128,Liga Profesional Argentina,971617,2023-07-07T00:30:00+00:00,Round - 23,445,Huracan,455,Atletico Tucuman,0,1,Huracan,26,25,Atletico Tucuman,11,37,-12,-15
2023,128,Liga Profesional Argentina,971616,2023-07-07T22:00:00+00:00,Round - 23,434,Gimnasia L.P.,453,Independiente,1,1,Gimnasia L.P.,22,30,Independiente,24,28,2,2
2023,128,Liga Profesional Argentina,971615,2023-07-08T00:30:00+00:00,Round - 23,1065,Central Cordoba de Santiago,457,Newells Old Boys,2,0,Central Cordoba de Santiago,23,29,Newells Old Boys,14,35,-6,-9
2023,128,Liga Profesional Argentina,971628,2023-07-08T21:00:00+00:00,Round - 24,450,Estudiantes L.P.,436,Racing Club,0,0,Estudiantes L.P.,5,45,Racing Club,12,36,9,7
2023,128,Liga Profesional Argentina,971629,2023-07-08T23:30:00+00:00,Round - 24,460,San Lorenzo,435,River Plate,0,0,San Lorenzo,3,46,River Plate,1,61,-15,-2
2023,128,Liga Profesional Argentina,988742,2023-07-09T18:30:00+00:00,Round - 24,478,Instituto Cordoba,452,Tigre,0,1,Instituto Cordoba,18,32,Tigre,16,34,-2,-2
2023,128,Liga Profesional Argentina,988743,2023-07-09T18:30:00+00:00,Round - 24,1064,Platense,474,Sarmiento Junin,1,0,Platense,17,34,Sarmiento Junin,19,30,4,2
2023,128,Liga Profesional Argentina,971634,2023-07-09T21:00:00+00:00,Round - 24,438,Velez Sarsfield,439,Godoy Cruz,1,1,Velez Sarsfield,25,27,Godoy Cruz,9,41,-14,-16
2023,128,Liga Profesional Argentina,971633,2023-07-09T23:30:00+00:00,Round - 24,442,Defensa Y Justicia,446,Lanus,2,2,Defensa Y Justicia,6,44,Lanus,4,45,-1,-2
2023,128,Liga Profesional Argentina,971632,2023-07-09T23:30:00+00:00,Round - 24,449,Banfield,459,Arsenal Sarandi,0,0,Banfield,21,30,Arsenal Sarandi,28,22,8,7
2023,128,Liga Profesional Argentina,971631,2023-07-10T17:00:00+00:00,Round - 24,2432,Barracas Central,458,Argentinos JRS,0,0,Barracas Central,15,35,Argentinos JRS,10,40,-5,-5
2023,128,Liga Profesional Argentina,971630,2023-07-10T19:30:00+00:00,Round - 24,448,Colon Santa Fe,440,Belgrano Cordoba,0,0,Colon Santa Fe,27,25,Belgrano Cordoba,13,36,-11,-14
2023,128,Liga Profesional Argentina,971636,2023-07-10T22:30:00+00:00,Round - 24,451,Boca Juniors,445,Huracan,1,0,Boca Juniors,7,44,Huracan,26,25,19,19
2023,128,Liga Profesional Argentina,971635,2023-07-11T00:30:00+00:00,Round - 24,456,Talleres Cordoba,441,Union Santa Fe,0,0,Talleres Cordoba,2,50,Union Santa Fe,20,30,20,18
2023,128,Liga Profesional Argentina,971627,2023-07-11T21:45:00+00:00,Round - 24,437,Rosario Central,1065,Central Cordoba de Santiago,2,0,Rosario Central,8,42,Central Cordoba de Santiago,23,29,13,15
2023,128,Liga Profesional Argentina,971638,2023-07-11T23:00:00+00:00,Round - 24,453,Independiente,457,Newells Old Boys,0,2,Independiente,24,28,Newells Old Boys,14,35,-7,-10
2023,128,Liga Profesional Argentina,971637,2023-07-12T00:30:00+00:00,Round - 24,455,Atletico Tucuman,434,Gimnasia L.P.,2,0,Atletico Tucuman,11,37,Gimnasia L.P.,22,30,7,11
2023,128,Liga Profesional Argentina,971644,2023-07-14T22:00:00+00:00,Round - 25,439,Godoy Cruz,442,Defensa Y Justicia,2,2,Godoy Cruz,9,41,Defensa Y Justicia,6,44,-3,-3
2023,128,Liga Profesional Argentina,988744,2023-07-14T22:00:00+00:00,Round - 25,474,Sarmiento Junin,438,Velez Sarsfield,1,1,Sarmiento Junin,19,30,Velez Sarsfield,25,27,3,6
2023,128,Liga Profesional Argentina,971642,2023-07-15T00:30:00+00:00,Round - 25,445,Huracan,456,Talleres Cordoba,0,1,Huracan,26,25,Talleres Cordoba,2,50,-25,-24
2023,128,Liga Profesional Argentina,971643,2023-07-15T17:00:00+00:00,Round - 25,441,Union Santa Fe,1064,Platense,0,0,Union Santa Fe,20,30,Platense,17,34,-4,-3
2023,128,Liga Profesional Argentina,971650,2023-07-15T19:00:00+00:00,Round - 25,436,Racing Club,437,Rosario Central,1,1,Racing Club,12,36,Rosario Central,8,42,-6,-4
2023,128,Liga Profesional Argentina,971649,2023-07-15T22:00:00+00:00,Round - 25,435,River Plate,450,Estudiantes L.P.,3,1,River Plate,1,61,Estudiantes L.P.,5,45,16,4
2023,128,Liga Profesional Argentina,971648,2023-07-16T17:00:00+00:00,Round - 25,440,Belgrano Cordoba,460,San Lorenzo,0,1,Belgrano Cordoba,13,36,San Lorenzo,3,46,-10,-10
2023,128,Liga Profesional Argentina,971641,2023-07-16T19:30:00+00:00,Round - 25,434,Gimnasia L.P.,451,Boca Juniors,1,3,Gimnasia L.P.,22,30,Boca Juniors,7,44,-14,-15
2023,128,Liga Profesional Argentina,971645,2023-07-16T22:00:00+00:00,Round - 25,446,Lanus,449,Banfield,2,2,Lanus,4,45,Banfield,21,30,15,17
2023,128,Liga Profesional Argentina,971647,2023-07-17T00:30:00+00:00,Round - 25,458,Argentinos JRS,448,Colon Santa Fe,1,0,Argentinos JRS,10,40,Colon Santa Fe,27,25,15,17
2023,128,Liga Profesional Argentina,971639,2023-07-17T00:30:00+00:00,Round - 25,1065,Central Cordoba de Santiago,453,Independiente,0,1,Central Cordoba de Santiago,23,29,Independiente,24,28,1,1
2023,128,Liga Profesional Argentina,971646,2023-07-17T21:00:00+00:00,Round - 25,452,Tigre,2432,Barracas Central,0,1,Tigre,16,34,Barracas Central,15,35,-1,-1
2023,128,Liga Profesional Argentina,988745,2023-07-17T21:00:00+00:00,Round - 25,459,Arsenal Sarandi,478,Instituto Cordoba,0,2,Arsenal Sarandi,28,22,Instituto Cordoba,18,32,-10,-10
2023,128,Liga Profesional Argentina,971640,2023-07-17T23:30:00+00:00,Round - 25,457,Newells Old Boys,455,Atletico Tucuman,0,0,Newells Old Boys,14,35,Atletico Tucuman,11,37,-2,-3
2023,128,Liga Profesional Argentina,971654,2023-07-22T18:30:00+00:00,Round - 26,460,San Lorenzo,458,Argentinos JRS,0,2,San Lorenzo,3,46,Argentinos JRS,10,40,6,7
2023,128,Liga Profesional Argentina,971653,2023-07-22T21:00:00+00:00,Round - 26,450,Estudiantes L.P.,440,Belgrano Cordoba,4,0,Estudiantes L.P.,5,45,Belgrano Cordoba,13,36,9,8
2023,128,Liga Profesional Argentina,971659,2023-07-22T23:30:00+00:00,Round - 26,1064,Platense,445,Huracan,0,1,Platense,17,34,Huracan,26,25,9,9
2023,128,Liga Profesional Argentina,971662,2023-07-23T19:30:00+00:00,Round - 26,455,Atletico Tucuman,453,Independiente,1,0,Atletico Tucuman,11,37,Independiente,24,28,9,13
2023,128,Liga Profesional Argentina,988747,2023-07-23T21:45:00+00:00,Round - 26,442,Defensa Y Justicia,474,Sarmiento Junin,3,0,Defensa Y Justicia,6,44,Sarmiento Junin,19,30,14,13
2023,128,Liga Profesional Argentina,971652,2023-07-24T00:00:00+00:00,Round - 26,437,Rosario Central,435,River Plate,3,3,Rosario Central,8,42,River Plate,1,61,-19,-7
2023,128,Liga Profesional Argentina,971658,2023-07-24T19:30:00+00:00,Round - 26,438,Velez Sarsfield,441,Union Santa Fe,0,0,Velez Sarsfield,25,27,Union Santa Fe,20,30,-3,-5
2023,128,Liga Profesional Argentina,971660,2023-07-24T19:30:00+00:00,Round - 26,456,Talleres Cordoba,434,Gimnasia L.P.,2,2,Talleres Cordoba,2,50,Gimnasia L.P.,22,30,20,20
2023,128,Liga Profesional Argentina,971657,2023-07-24T21:30:00+00:00,Round - 26,449,Banfield,439,Godoy Cruz,2,0,Banfield,21,30,Godoy Cruz,9,41,-11,-12
2023,128,Liga Profesional Argentina,971651,2023-07-24T22:30:00+00:00,Round - 26,436,Racing Club,1065,Central Cordoba de Santiago,3,1,Racing Club,12,36,Central Cordoba de Santiago,23,29,7,11
2023,128,Liga Profesional Argentina,971661,2023-07-24T23:45:00+00:00,Round - 26,451,Boca Juniors,457,Newells Old Boys,2,1,Boca Juniors,7,44,Newells Old Boys,14,35,9,7
2023,128,Liga Profesional Argentina,971656,2023-07-25T18:30:00+00:00,Round - 26,2432,Barracas Central,459,Arsenal Sarandi,0,0,Barracas Central,15,35,Arsenal Sarandi,28,22,13,13
2023,128,Liga Profesional Argentina,971655,2023-07-25T21:00:00+00:00,Round - 26,448,Colon Santa Fe,452,Tigre,1,3,Colon Santa Fe,27,25,Tigre,16,34,-9,-11
2023,128,Liga Profesional Argentina,988746,2023-07-25T23:30:00+00:00,Round - 26,478,Instituto Cordoba,446,Lanus,2,1,Instituto Cordoba,18,32,Lanus,4,45,-13,-14
2023,128,Liga Profesional Argentina,971668,2023-07-28T19:30:00+00:00,Round - 27,441,Union Santa Fe,442,Defensa Y Justicia,2,0,Union Santa Fe,20,30,Defensa Y Justicia,6,44,-14,-14
2023,128,Liga Profesional Argentina,971672,2023-07-28T19:30:00+00:00,Round - 27,458,Argentinos JRS,450,Estudiantes L.P.,2,3,Argentinos JRS,10,40,Estudiantes L.P.,5,45,-5,-5
2023,128,Liga Profesional Argentina,971673,2023-07-28T22:00:00+00:00,Round - 27,440,Belgrano Cordoba,437,Rosario Central,0,0,Belgrano Cordoba,13,36,Rosario Central,8,42,-6,-5
2023,128,Liga Profesional Argentina,971665,2023-07-28T22:00:00+00:00,Round - 27,457,Newells Old Boys,456,Talleres Cordoba,1,1,Newells Old Boys,14,35,Talleres Cordoba,2,50,-15,-12
2023,128,Liga Profesional Argentina,971674,2023-07-29T00:30:00+00:00,Round - 27,435,River Plate,436,Racing Club,2,1,River Plate,1,61,Racing Club,12,36,25,11
2023,128,Liga Profesional Argentina,971663,2023-07-29T17:30:00+00:00,Round - 27,1065,Central Cordoba de Santiago,455,Atletico Tucuman,0,2,Central Cordoba de Santiago,23,29,Atletico Tucuman,11,37,-8,-12
2023,128,Liga Profesional Argentina,988748,2023-07-29T18:00:00+00:00,Round - 27,474,Sarmiento Junin,449,Banfield,0,0,Sarmiento Junin,19,30,Banfield,21,30,0,2
2023,128,Liga Profesional Argentina,971664,2023-07-29T20:00:00+00:00,Round - 27,453,Independiente,451,Boca Juniors,0,2,Independiente,24,28,Boca Juniors,7,44,-16,-17
2023,128,Liga Profesional Argentina,971671,2023-07-29T23:00:00+00:00,Round - 27,452,Tigre,460,San Lorenzo,2,0,Tigre,16,34,San Lorenzo,3,46,-12,-13
2023,128,Liga Profesional Argentina,971669,2023-07-30T18:00:00+00:00,Round - 27,446,Lanus,2432,Barracas Central,2,0,Lanus,4,45,Barracas Central,15,35,10,11
2023,128,Liga Profesional Argentina,971670,2023-07-30T18:00:00+00:00,Round - 27,459,Arsenal Sarandi,448,Colon Santa Fe,2,0,Arsenal Sarandi,28,22,Colon Santa Fe,27,25,-3,-1
2023,128,Liga Profesional Argentina,971666,2023-07-30T20:30:00+00:00,Round - 27,434,Gimnasia L.P.,1064,Platense,1,1,Gimnasia L.P.,22,30,Platense,17,34,-4,-5
2023,128,Liga Profesional Argentina,971667,2023-07-30T20:30:00+00:00,Round - 27,445,Huracan,438,Velez Sarsfield,1,0,Huracan,26,25,Velez Sarsfield,25,27,-2,-1
2023,128,Liga Profesional Argentina,988749,2023-07-30T23:00:00+00:00,Round - 27,439,Godoy Cruz,478,Instituto Cordoba,4,2,Godoy Cruz,9,41,Instituto Cordoba,18,32,9,9
